"date","geography","geography code","Tenure: All households; measures: Value","Tenure: Owned; measures: Value","Tenure: Owned: Owned outright; measures: Value","Tenure: Owned: Owned with a mortgage or loan; measures: Value","Tenure: Shared ownership (part owned and part rented); measures: Value","Tenure: Social rented; measures: Value","Tenure: Social rented: Rented from council (Local Authority); measures: Value","Tenure: Social rented: Other; measures: Value","Tenure: Private rented; measures: Value","Tenure: Private rented: Private landlord or letting agency; measures: Value","Tenure: Private rented: Other; measures: Value","Tenure: Living rent free; measures: Value"
"2011","N00000001 (Aldergrove ward)","N00000001",310,26,5,21,0,9,2,7,270,24,246,5
"2011","N00000002 (Aldergrove ward)","N00000002",141,113,43,70,0,8,8,0,15,13,2,5
"2011","N00000003 (Aldergrove ward)","N00000003",78,71,39,32,0,0,0,0,5,2,3,2
"2011","N00000004 (Aldergrove ward)","N00000004",195,167,72,95,0,4,3,1,18,14,4,6
"2011","N00000005 (Aldergrove ward)","N00000005",124,113,38,75,0,0,0,0,10,9,1,1
"2011","N00000006 (Aldergrove ward)","N00000006",86,76,38,38,0,0,0,0,10,7,3,0
"2011","N00000007 (Aldergrove ward)","N00000007",89,69,43,26,0,1,0,1,13,8,5,6
"2011","N00000008 (Aldergrove ward)","N00000008",138,97,36,61,1,2,2,0,34,32,2,4
"2011","N00000009 (Aldergrove ward)","N00000009",275,228,83,145,0,1,1,0,42,40,2,4
"2011","N00000010 (Aldergrove ward)","N00000010",86,74,53,21,0,0,0,0,10,5,5,2
"2011","N00000011 (Balloo ward)","N00000011",136,85,47,38,2,23,23,0,19,18,1,7
"2011","N00000012 (Balloo ward)","N00000012",121,90,49,41,1,14,14,0,14,13,1,2
"2011","N00000013 (Balloo ward)","N00000013",136,80,50,30,1,9,9,0,40,38,2,6
"2011","N00000014 (Balloo ward)","N00000014",205,125,42,83,0,29,23,6,46,41,5,5
"2011","N00000015 (Balloo ward)","N00000015",119,58,36,22,1,42,41,1,16,13,3,2
"2011","N00000016 (Balloo ward)","N00000016",122,60,29,31,0,31,31,0,27,25,2,4
"2011","N00000017 (Ballycraigy ward)","N00000017",144,79,27,52,2,48,47,1,12,11,1,3
"2011","N00000018 (Ballycraigy ward)","N00000018",94,74,25,49,0,1,1,0,19,17,2,0
"2011","N00000019 (Ballycraigy ward)","N00000019",116,69,36,33,0,28,23,5,18,16,2,1
"2011","N00000020 (Ballycraigy ward)","N00000020",122,42,21,21,1,62,61,1,14,13,1,3
"2011","N00000021 (Ballycraigy ward)","N00000021",128,72,31,41,3,23,23,0,28,27,1,2
"2011","N00000022 (Ballycraigy ward)","N00000022",126,73,33,40,1,30,30,0,19,18,1,3
"2011","N00000023 (Ballycraigy ward)","N00000023",115,60,33,27,0,41,41,0,11,10,1,3
"2011","N00000024 (Clady ward)","N00000024",174,158,71,87,1,1,1,0,9,8,1,5
"2011","N00000025 (Clady ward)","N00000025",159,147,80,67,0,1,1,0,6,4,2,5
"2011","N00000026 (Clady ward)","N00000026",151,139,82,57,0,2,2,0,6,6,0,4
"2011","N00000027 (Clady ward)","N00000027",178,151,72,79,3,0,0,0,21,20,1,3
"2011","N00000028 (Clady ward)","N00000028",85,79,27,52,1,0,0,0,5,5,0,0
"2011","N00000029 (Clady ward)","N00000029",136,125,76,49,0,1,1,0,6,4,2,4
"2011","N00000030 (Clady ward)","N00000030",131,120,72,48,0,0,0,0,8,6,2,3
"2011","N00000031 (Cranfield ward)","N00000031",201,178,92,86,2,4,4,0,15,12,3,2
"2011","N00000032 (Cranfield ward)","N00000032",133,117,64,53,1,0,0,0,11,10,1,4
"2011","N00000033 (Cranfield ward)","N00000033",166,145,73,72,0,1,1,0,13,11,2,7
"2011","N00000034 (Cranfield ward)","N00000034",158,132,57,75,0,5,5,0,16,13,3,5
"2011","N00000035 (Cranfield ward)","N00000035",128,64,30,34,0,39,39,0,21,19,2,4
"2011","N00000036 (Cranfield ward)","N00000036",134,91,41,50,0,19,19,0,22,18,4,2
"2011","N00000037 (Crumlin ward)","N00000037",124,109,50,59,2,4,4,0,7,7,0,2
"2011","N00000038 (Crumlin ward)","N00000038",138,113,48,65,0,5,0,5,17,12,5,3
"2011","N00000039 (Crumlin ward)","N00000039",448,320,82,238,8,65,34,31,47,35,12,8
"2011","N00000040 (Crumlin ward)","N00000040",114,61,15,46,1,31,31,0,11,9,2,10
"2011","N00000041 (Crumlin ward)","N00000041",144,121,20,101,2,3,3,0,16,14,2,2
"2011","N00000042 (Crumlin ward)","N00000042",126,116,32,84,0,1,1,0,8,6,2,1
"2011","N00000043 (Crumlin ward)","N00000043",368,294,65,229,3,34,21,13,34,26,8,3
"2011","N00000044 (Crumlin ward)","N00000044",108,78,25,53,3,16,2,14,9,6,3,2
"2011","N00000045 (Drumanaway ward)","N00000045",170,151,73,78,0,2,2,0,13,11,2,4
"2011","N00000046 (Drumanaway ward)","N00000046",129,114,73,41,0,6,6,0,6,5,1,3
"2011","N00000047 (Drumanaway ward)","N00000047",138,118,75,43,0,4,4,0,14,12,2,2
"2011","N00000048 (Drumanaway ward)","N00000048",125,69,33,36,1,23,23,0,30,26,4,2
"2011","N00000049 (Drumanaway ward)","N00000049",123,64,30,34,0,30,30,0,26,21,5,3
"2011","N00000050 (Drumanaway ward)","N00000050",135,101,60,41,0,5,4,1,21,20,1,8
"2011","N00000051 (Farranshane ward)","N00000051",124,55,16,39,1,58,58,0,4,4,0,6
"2011","N00000052 (Farranshane ward)","N00000052",120,65,31,34,1,35,34,1,11,9,2,8
"2011","N00000053 (Farranshane ward)","N00000053",108,54,17,37,2,14,14,0,35,34,1,3
"2011","N00000054 (Farranshane ward)","N00000054",111,64,19,45,2,25,25,0,18,17,1,2
"2011","N00000055 (Farranshane ward)","N00000055",117,87,44,43,5,8,8,0,16,16,0,1
"2011","N00000056 (Farranshane ward)","N00000056",119,79,44,35,1,21,21,0,17,16,1,1
"2011","N00000057 (Fountain Hill ward)","N00000057",118,40,15,25,0,58,58,0,18,18,0,2
"2011","N00000058 (Fountain Hill ward)","N00000058",121,58,25,33,0,40,40,0,19,17,2,4
"2011","N00000059 (Fountain Hill ward)","N00000059",110,41,18,23,0,48,47,1,17,17,0,4
"2011","N00000060 (Fountain Hill ward)","N00000060",180,79,24,55,1,67,66,1,28,27,1,5
"2011","N00000061 (Fountain Hill ward)","N00000061",129,106,68,38,0,11,11,0,8,8,0,4
"2011","N00000062 (Fountain Hill ward)","N00000062",130,116,71,45,0,4,4,0,8,8,0,2
"2011","N00000063 (Fountain Hill ward)","N00000063",155,75,27,48,0,48,48,0,31,29,2,1
"2011","N00000064 (Greystone ward)","N00000064",133,35,10,25,1,75,75,0,14,14,0,8
"2011","N00000065 (Greystone ward)","N00000065",146,130,65,65,5,3,3,0,7,4,3,1
"2011","N00000066 (Greystone ward)","N00000066",110,98,54,44,0,3,3,0,5,4,1,4
"2011","N00000067 (Greystone ward)","N00000067",134,65,26,39,0,53,53,0,14,13,1,2
"2011","N00000068 (Greystone ward)","N00000068",124,113,62,51,0,1,1,0,9,7,2,1
"2011","N00000069 (Greystone ward)","N00000069",145,42,17,25,0,87,81,6,13,12,1,3
"2011","N00000070 (Massereene ward)","N00000070",104,96,67,29,0,0,0,0,6,4,2,2
"2011","N00000071 (Massereene ward)","N00000071",136,85,53,32,1,10,10,0,28,23,5,12
"2011","N00000072 (Massereene ward)","N00000072",634,492,108,384,4,36,35,1,93,87,6,9
"2011","N00000073 (Massereene ward)","N00000073",249,121,46,75,1,42,16,26,78,71,7,7
"2011","N00000074 (Massereene ward)","N00000074",386,317,60,257,6,7,1,6,51,49,2,5
"2011","N00000075 (Massereene ward)","N00000075",111,86,44,42,2,4,0,4,17,15,2,2
"2011","N00000076 (Massereene ward)","N00000076",114,99,36,63,0,0,0,0,14,14,0,1
"2011","N00000077 (Massereene ward)","N00000077",98,89,32,57,0,0,0,0,7,6,1,2
"2011","N00000078 (Massereene ward)","N00000078",161,146,32,114,0,1,1,0,14,14,0,0
"2011","N00000079 (Parkgate ward)","N00000079",192,172,78,94,0,1,0,1,13,11,2,6
"2011","N00000080 (Parkgate ward)","N00000080",146,131,57,74,0,3,2,1,7,6,1,5
"2011","N00000081 (Parkgate ward)","N00000081",140,88,34,54,1,27,19,8,15,13,2,9
"2011","N00000082 (Parkgate ward)","N00000082",132,114,73,41,0,0,0,0,11,10,1,7
"2011","N00000083 (Parkgate ward)","N00000083",208,193,96,97,0,0,0,0,10,8,2,5
"2011","N00000084 (Parkgate ward)","N00000084",153,139,82,57,0,2,1,1,8,8,0,4
"2011","N00000085 (Randalstown ward)","N00000085",180,84,44,40,0,42,19,23,53,48,5,1
"2011","N00000086 (Randalstown ward)","N00000086",142,89,39,50,2,3,1,2,42,39,3,6
"2011","N00000087 (Randalstown ward)","N00000087",303,254,112,142,1,1,1,0,34,28,6,13
"2011","N00000088 (Randalstown ward)","N00000088",136,45,27,18,1,66,32,34,20,18,2,4
"2011","N00000089 (Randalstown ward)","N00000089",164,138,34,104,1,3,3,0,19,17,2,3
"2011","N00000090 (Randalstown ward)","N00000090",138,116,41,75,0,1,1,0,20,18,2,1
"2011","N00000091 (Randalstown ward)","N00000091",176,119,45,74,0,0,0,0,56,54,2,1
"2011","N00000092 (Shilvodan ward)","N00000092",168,152,85,67,0,1,1,0,9,7,2,6
"2011","N00000093 (Shilvodan ward)","N00000093",140,123,83,40,0,2,2,0,13,10,3,2
"2011","N00000094 (Shilvodan ward)","N00000094",161,149,90,59,0,0,0,0,9,8,1,3
"2011","N00000095 (Shilvodan ward)","N00000095",152,137,76,61,0,0,0,0,11,10,1,4
"2011","N00000096 (Shilvodan ward)","N00000096",158,145,91,54,1,1,0,1,7,7,0,4
"2011","N00000097 (Springfarm ward)","N00000097",296,226,41,185,7,6,6,0,55,51,4,2
"2011","N00000098 (Springfarm ward)","N00000098",446,338,77,261,9,2,2,0,94,89,5,3
"2011","N00000099 (Springfarm ward)","N00000099",107,53,18,35,0,40,40,0,12,8,4,2
"2011","N00000100 (Springfarm ward)","N00000100",164,79,24,55,2,49,49,0,25,20,5,9
"2011","N00000101 (Springfarm ward)","N00000101",122,30,8,22,0,67,66,1,18,16,2,7
"2011","N00000102 (Springfarm ward)","N00000102",125,80,34,46,0,31,31,0,13,11,2,1
"2011","N00000103 (Springfarm ward)","N00000103",205,105,20,85,3,51,51,0,41,40,1,5
"2011","N00000104 (Springfarm ward)","N00000104",130,62,8,54,3,34,34,0,28,27,1,3
"2011","N00000105 (Steeple ward)","N00000105",148,89,39,50,0,31,29,2,22,19,3,6
"2011","N00000106 (Steeple ward)","N00000106",103,31,12,19,0,58,57,1,10,10,0,4
"2011","N00000107 (Steeple ward)","N00000107",120,53,16,37,3,42,42,0,20,18,2,2
"2011","N00000108 (Steeple ward)","N00000108",110,83,45,38,0,11,11,0,11,10,1,5
"2011","N00000109 (Steeple ward)","N00000109",229,123,37,86,3,39,39,0,59,56,3,5
"2011","N00000110 (Steeple ward)","N00000110",122,68,34,34,0,26,26,0,26,26,0,2
"2011","N00000111 (Stiles ward)","N00000111",136,117,47,70,4,1,1,0,11,10,1,3
"2011","N00000112 (Stiles ward)","N00000112",143,109,27,82,2,17,17,0,12,11,1,3
"2011","N00000113 (Stiles ward)","N00000113",122,87,27,60,1,13,12,1,15,15,0,6
"2011","N00000114 (Stiles ward)","N00000114",121,105,37,68,4,3,3,0,9,7,2,0
"2011","N00000115 (Stiles ward)","N00000115",128,73,35,38,3,37,37,0,11,9,2,4
"2011","N00000116 (Stiles ward)","N00000116",119,69,17,52,1,36,36,0,10,10,0,3
"2011","N00000117 (Stiles ward)","N00000117",86,23,5,18,0,51,35,16,10,8,2,2
"2011","N00000118 (Templepatrick ward)","N00000118",143,95,68,27,1,2,0,2,39,35,4,6
"2011","N00000119 (Templepatrick ward)","N00000119",125,120,81,39,1,0,0,0,4,4,0,0
"2011","N00000120 (Templepatrick ward)","N00000120",127,112,77,35,0,1,1,0,7,5,2,7
"2011","N00000121 (Templepatrick ward)","N00000121",124,93,55,38,0,5,5,0,24,21,3,2
"2011","N00000122 (Templepatrick ward)","N00000122",199,164,79,85,0,1,1,0,30,25,5,4
"2011","N00000123 (Templepatrick ward)","N00000123",143,134,88,46,0,0,0,0,9,7,2,0
"2011","N00000124 (Templepatrick ward)","N00000124",143,122,71,51,0,1,1,0,15,12,3,5
"2011","N00000125 (Toome ward)","N00000125",148,121,73,48,0,6,5,1,16,14,2,5
"2011","N00000126 (Toome ward)","N00000126",134,118,69,49,0,2,2,0,11,9,2,3
"2011","N00000127 (Toome ward)","N00000127",130,93,49,44,0,17,17,0,18,15,3,2
"2011","N00000128 (Toome ward)","N00000128",282,236,130,106,1,9,8,1,30,22,8,6
"2011","N00000129 (Toome ward)","N00000129",138,35,18,17,0,76,67,9,17,11,6,10
"2011","N00003887 (Abbey ward)","N00003887",254,176,109,67,1,43,41,2,31,28,3,3
"2011","N00003888 (Abbey ward)","N00003888",98,91,48,43,0,1,1,0,5,4,1,1
"2011","N00003889 (Abbey ward)","N00003889",157,86,40,46,1,29,17,12,38,37,1,3
"2011","N00003890 (Abbey ward)","N00003890",127,50,33,17,1,48,28,20,25,23,2,3
"2011","N00003891 (Abbey ward)","N00003891",136,93,38,55,4,2,0,2,34,32,2,3
"2011","N00003892 (Abbey ward)","N00003892",123,72,31,41,3,7,0,7,39,38,1,2
"2011","N00003893 (Abbey ward)","N00003893",116,79,44,35,1,2,2,0,33,32,1,1
"2011","N00003894 (Abbey ward)","N00003894",122,83,36,47,0,14,4,10,23,18,5,2
"2011","N00003895 (Abbey ward)","N00003895",124,84,37,47,2,1,1,0,33,30,3,4
"2011","N00003896 (Ballyclare North ward)","N00003896",381,165,87,78,1,161,143,18,36,31,5,18
"2011","N00003897 (Ballyclare North ward)","N00003897",103,35,12,23,2,52,52,0,10,9,1,4
"2011","N00003898 (Ballyclare North ward)","N00003898",127,117,49,68,1,2,2,0,6,6,0,1
"2011","N00003899 (Ballyclare North ward)","N00003899",131,122,55,67,1,1,1,0,5,4,1,2
"2011","N00003900 (Ballyclare North ward)","N00003900",132,60,25,35,2,61,61,0,6,6,0,3
"2011","N00003901 (Ballyclare North ward)","N00003901",116,37,17,20,2,64,64,0,8,8,0,5
"2011","N00003902 (Ballyclare North ward)","N00003902",130,118,81,37,0,1,1,0,10,10,0,1
"2011","N00003903 (Ballyclare North ward)","N00003903",211,194,42,152,1,4,4,0,11,10,1,1
"2011","N00003904 (Ballyclare North ward)","N00003904",202,171,70,101,2,8,8,0,20,16,4,1
"2011","N00003905 (Ballyclare South ward)","N00003905",153,83,40,43,2,44,44,0,14,13,1,10
"2011","N00003906 (Ballyclare South ward)","N00003906",111,62,29,33,1,1,1,0,44,43,1,3
"2011","N00003907 (Ballyclare South ward)","N00003907",136,91,41,50,5,3,2,1,34,31,3,3
"2011","N00003908 (Ballyclare South ward)","N00003908",110,42,17,25,1,42,8,34,21,17,4,4
"2011","N00003909 (Ballyclare South ward)","N00003909",144,80,37,43,2,24,24,0,37,35,2,1
"2011","N00003910 (Ballyclare South ward)","N00003910",113,88,50,38,0,8,7,1,12,10,2,5
"2011","N00003911 (Ballyclare South ward)","N00003911",507,400,119,281,5,18,16,2,78,75,3,6
"2011","N00003912 (Ballyclare South ward)","N00003912",188,152,59,93,1,2,2,0,33,31,2,0
"2011","N00003913 (Ballyclare South ward)","N00003913",121,76,37,39,1,23,23,0,18,15,3,3
"2011","N00003914 (Ballyduff ward)","N00003914",130,118,40,78,1,4,4,0,7,7,0,0
"2011","N00003915 (Ballyduff ward)","N00003915",122,70,26,44,5,26,26,0,20,18,2,1
"2011","N00003916 (Ballyduff ward)","N00003916",129,118,38,80,0,0,0,0,11,10,1,0
"2011","N00003917 (Ballyduff ward)","N00003917",112,87,37,50,0,10,10,0,11,10,1,4
"2011","N00003918 (Ballyduff ward)","N00003918",121,76,26,50,1,27,26,1,13,10,3,4
"2011","N00003919 (Ballyduff ward)","N00003919",122,107,55,52,0,2,1,1,10,7,3,3
"2011","N00003920 (Ballyduff ward)","N00003920",118,104,33,71,1,0,0,0,13,12,1,0
"2011","N00003921 (Ballyduff ward)","N00003921",121,112,46,66,3,0,0,0,6,6,0,0
"2011","N00003922 (Ballyduff ward)","N00003922",123,106,43,63,1,0,0,0,15,14,1,1
"2011","N00003923 (Ballyhenry ward)","N00003923",119,110,41,69,0,0,0,0,6,5,1,3
"2011","N00003924 (Ballyhenry ward)","N00003924",127,95,39,56,0,11,11,0,19,18,1,2
"2011","N00003925 (Ballyhenry ward)","N00003925",114,93,32,61,2,1,1,0,14,9,5,4
"2011","N00003926 (Ballyhenry ward)","N00003926",109,100,49,51,0,1,1,0,6,5,1,2
"2011","N00003927 (Ballyhenry ward)","N00003927",111,101,43,58,3,1,0,1,5,5,0,1
"2011","N00003928 (Ballyhenry ward)","N00003928",204,136,68,68,1,37,6,31,29,27,2,1
"2011","N00003929 (Ballyhenry ward)","N00003929",113,97,50,47,0,2,2,0,12,12,0,2
"2011","N00003930 (Ballyhenry ward)","N00003930",137,114,66,48,0,1,0,1,20,18,2,2
"2011","N00003931 (Ballyhenry ward)","N00003931",123,61,27,34,2,44,44,0,12,12,0,4
"2011","N00003932 (Ballynure ward)","N00003932",150,124,68,56,4,0,0,0,18,17,1,4
"2011","N00003933 (Ballynure ward)","N00003933",314,276,148,128,2,2,2,0,25,20,5,9
"2011","N00003934 (Ballynure ward)","N00003934",116,105,64,41,0,0,0,0,8,6,2,3
"2011","N00003935 (Ballynure ward)","N00003935",136,126,74,52,0,1,1,0,5,4,1,4
"2011","N00003936 (Ballynure ward)","N00003936",358,304,105,199,3,13,12,1,34,31,3,4
"2011","N00003937 (Ballynure ward)","N00003937",124,109,68,41,0,1,1,0,7,4,3,7
"2011","N00003938 (Ballyrobert ward)","N00003938",113,105,62,43,1,0,0,0,7,6,1,0
"2011","N00003939 (Ballyrobert ward)","N00003939",140,130,65,65,0,2,2,0,3,2,1,5
"2011","N00003940 (Ballyrobert ward)","N00003940",128,116,72,44,0,0,0,0,11,10,1,1
"2011","N00003941 (Ballyrobert ward)","N00003941",138,128,77,51,0,0,0,0,9,7,2,1
"2011","N00003942 (Ballyrobert ward)","N00003942",158,142,45,97,0,0,0,0,13,12,1,3
"2011","N00003943 (Ballyrobert ward)","N00003943",284,228,102,126,4,1,1,0,49,46,3,2
"2011","N00003944 (Ballyrobert ward)","N00003944",131,116,36,80,5,0,0,0,8,6,2,2
"2011","N00003945 (Ballyrobert ward)","N00003945",122,111,58,53,1,0,0,0,9,6,3,1
"2011","N00003946 (Ballyrobert ward)","N00003946",156,142,35,107,2,0,0,0,11,9,2,1
"2011","N00003947 (Ballyrobert ward)","N00003947",232,202,66,136,5,1,1,0,20,19,1,4
"2011","N00003948 (Burnthill ward)","N00003948",123,117,56,61,3,1,1,0,2,1,1,0
"2011","N00003949 (Burnthill ward)","N00003949",120,102,39,63,5,0,0,0,13,11,2,0
"2011","N00003950 (Burnthill ward)","N00003950",113,99,33,66,1,1,1,0,12,11,1,0
"2011","N00003951 (Burnthill ward)","N00003951",109,95,54,41,2,0,0,0,12,12,0,0
"2011","N00003952 (Burnthill ward)","N00003952",114,105,58,47,0,1,1,0,6,5,1,2
"2011","N00003953 (Burnthill ward)","N00003953",111,105,57,48,1,0,0,0,4,4,0,1
"2011","N00003954 (Burnthill ward)","N00003954",116,84,59,25,0,23,0,23,5,4,1,4
"2011","N00003955 (Burnthill ward)","N00003955",114,100,53,47,1,1,1,0,9,9,0,3
"2011","N00003956 (Burnthill ward)","N00003956",117,107,45,62,1,0,0,0,9,9,0,0
"2011","N00003957 (Carnmoney ward)","N00003957",108,24,10,14,3,63,63,0,11,11,0,7
"2011","N00003958 (Carnmoney ward)","N00003958",240,97,27,70,1,123,96,27,10,10,0,9
"2011","N00003959 (Carnmoney ward)","N00003959",119,97,67,30,0,14,14,0,5,4,1,3
"2011","N00003960 (Carnmoney ward)","N00003960",129,115,70,45,1,0,0,0,12,11,1,1
"2011","N00003961 (Carnmoney ward)","N00003961",130,123,81,42,0,1,1,0,6,6,0,0
"2011","N00003962 (Carnmoney ward)","N00003962",261,251,139,112,1,2,2,0,7,7,0,0
"2011","N00003963 (Carnmoney ward)","N00003963",124,116,74,42,1,1,1,0,5,5,0,1
"2011","N00003964 (Cloughfern ward)","N00003964",135,100,36,64,0,15,15,0,18,16,2,2
"2011","N00003965 (Cloughfern ward)","N00003965",154,138,41,97,2,2,2,0,10,7,3,2
"2011","N00003966 (Cloughfern ward)","N00003966",135,78,33,45,1,31,30,1,19,19,0,6
"2011","N00003967 (Cloughfern ward)","N00003967",110,106,15,91,0,1,1,0,2,2,0,1
"2011","N00003968 (Cloughfern ward)","N00003968",119,90,41,49,6,5,5,0,16,13,3,2
"2011","N00003969 (Cloughfern ward)","N00003969",120,109,66,43,0,1,0,1,9,7,2,1
"2011","N00003970 (Cloughfern ward)","N00003970",139,105,44,61,1,5,0,5,25,25,0,3
"2011","N00003971 (Cloughfern ward)","N00003971",123,94,42,52,2,6,5,1,17,17,0,4
"2011","N00003972 (Cloughfern ward)","N00003972",141,87,35,52,1,29,29,0,15,15,0,9
"2011","N00003973 (Collinbridge ward)","N00003973",124,120,67,53,0,1,0,1,3,3,0,0
"2011","N00003974 (Collinbridge ward)","N00003974",198,179,40,139,0,1,1,0,18,15,3,0
"2011","N00003975 (Collinbridge ward)","N00003975",130,124,48,76,4,0,0,0,2,2,0,0
"2011","N00003976 (Collinbridge ward)","N00003976",126,115,35,80,5,0,0,0,6,5,1,0
"2011","N00003977 (Collinbridge ward)","N00003977",107,93,42,51,0,1,1,0,12,11,1,1
"2011","N00003978 (Collinbridge ward)","N00003978",139,119,54,65,2,0,0,0,17,12,5,1
"2011","N00003979 (Collinbridge ward)","N00003979",137,117,54,63,0,1,1,0,16,14,2,3
"2011","N00003980 (Collinbridge ward)","N00003980",145,137,84,53,0,1,1,0,6,5,1,1
"2011","N00003981 (Coole ward)","N00003981",115,85,47,38,0,23,23,0,5,2,3,2
"2011","N00003982 (Coole ward)","N00003982",117,63,24,39,1,9,6,3,42,37,5,2
"2011","N00003983 (Coole ward)","N00003983",118,58,19,39,5,42,41,1,11,11,0,2
"2011","N00003984 (Coole ward)","N00003984",133,69,35,34,3,39,39,0,20,19,1,2
"2011","N00003985 (Coole ward)","N00003985",120,62,24,38,1,46,46,0,5,4,1,6
"2011","N00003986 (Coole ward)","N00003986",123,50,29,21,1,55,55,0,11,11,0,6
"2011","N00003987 (Coole ward)","N00003987",123,53,22,31,1,58,58,0,6,6,0,5
"2011","N00003988 (Coole ward)","N00003988",130,61,34,27,0,54,54,0,10,8,2,5
"2011","N00003989 (Coole ward)","N00003989",121,26,11,15,1,71,71,0,14,13,1,9
"2011","N00003990 (Doagh ward)","N00003990",177,156,78,78,1,2,2,0,14,12,2,4
"2011","N00003991 (Doagh ward)","N00003991",140,72,36,36,3,48,48,0,11,11,0,6
"2011","N00003992 (Doagh ward)","N00003992",154,122,55,67,1,2,1,1,25,23,2,4
"2011","N00003993 (Doagh ward)","N00003993",158,134,68,66,1,2,2,0,20,19,1,1
"2011","N00003994 (Doagh ward)","N00003994",123,118,41,77,0,0,0,0,4,3,1,1
"2011","N00003995 (Doagh ward)","N00003995",140,122,67,55,0,0,0,0,14,13,1,4
"2011","N00003996 (Doagh ward)","N00003996",147,109,42,67,0,21,20,1,12,7,5,5
"2011","N00003997 (Doagh ward)","N00003997",128,115,59,56,0,2,1,1,9,8,1,2
"2011","N00003998 (Doagh ward)","N00003998",127,113,27,86,2,3,3,0,9,9,0,0
"2011","N00003999 (Doagh ward)","N00003999",139,127,27,100,0,1,1,0,9,9,0,2
"2011","N00004000 (Dunanney ward)","N00004000",152,61,22,39,0,63,36,27,23,19,4,5
"2011","N00004001 (Dunanney ward)","N00004001",125,58,14,44,2,51,49,2,12,10,2,2
"2011","N00004002 (Dunanney ward)","N00004002",160,59,34,25,0,73,63,10,20,18,2,8
"2011","N00004003 (Dunanney ward)","N00004003",184,84,27,57,6,65,65,0,25,22,3,4
"2011","N00004004 (Dunanney ward)","N00004004",114,34,18,16,1,65,65,0,12,12,0,2
"2011","N00004005 (Dunanney ward)","N00004005",95,28,17,11,0,56,56,0,7,6,1,4
"2011","N00004006 (Dunanney ward)","N00004006",110,57,24,33,0,43,43,0,5,5,0,5
"2011","N00004007 (Dunanney ward)","N00004007",103,43,18,25,1,38,38,0,16,16,0,5
"2011","N00004008 (Glebe ward)","N00004008",146,121,48,73,1,1,0,1,20,19,1,3
"2011","N00004009 (Glebe ward)","N00004009",126,110,43,67,2,1,1,0,13,12,1,0
"2011","N00004010 (Glebe ward)","N00004010",144,133,52,81,1,0,0,0,10,9,1,0
"2011","N00004011 (Glebe ward)","N00004011",183,147,54,93,3,0,0,0,31,30,1,2
"2011","N00004012 (Glebe ward)","N00004012",124,117,66,51,2,0,0,0,4,3,1,1
"2011","N00004013 (Glebe ward)","N00004013",118,100,34,66,0,1,1,0,12,11,1,5
"2011","N00004014 (Glebe ward)","N00004014",124,119,55,64,1,1,0,1,2,2,0,1
"2011","N00004015 (Glebe ward)","N00004015",113,100,39,61,0,1,1,0,11,10,1,1
"2011","N00004016 (Glebe ward)","N00004016",151,131,62,69,0,2,2,0,17,15,2,1
"2011","N00004017 (Glengormley ward)","N00004017",108,88,40,48,4,1,1,0,15,13,2,0
"2011","N00004018 (Glengormley ward)","N00004018",123,108,61,47,1,0,0,0,13,13,0,1
"2011","N00004019 (Glengormley ward)","N00004019",118,102,37,65,1,1,1,0,14,12,2,0
"2011","N00004020 (Glengormley ward)","N00004020",143,123,43,80,3,3,2,1,14,14,0,0
"2011","N00004021 (Glengormley ward)","N00004021",129,103,59,44,0,2,2,0,22,19,3,2
"2011","N00004022 (Glengormley ward)","N00004022",151,65,25,40,2,57,56,1,21,20,1,6
"2011","N00004023 (Glengormley ward)","N00004023",119,88,27,61,2,13,13,0,15,15,0,1
"2011","N00004024 (Glengormley ward)","N00004024",126,67,19,48,2,35,35,0,21,21,0,1
"2011","N00004025 (Glengormley ward)","N00004025",243,101,42,59,4,96,37,59,36,33,3,6
"2011","N00004026 (Hawthorne ward)","N00004026",126,107,61,46,2,1,1,0,16,15,1,0
"2011","N00004027 (Hawthorne ward)","N00004027",130,117,68,49,0,8,8,0,4,4,0,1
"2011","N00004028 (Hawthorne ward)","N00004028",118,99,45,54,0,11,10,1,6,6,0,2
"2011","N00004029 (Hawthorne ward)","N00004029",123,117,75,42,0,2,1,1,2,2,0,2
"2011","N00004030 (Hawthorne ward)","N00004030",129,100,45,55,2,17,17,0,8,7,1,2
"2011","N00004031 (Hawthorne ward)","N00004031",127,58,25,33,2,56,55,1,10,8,2,1
"2011","N00004032 (Hawthorne ward)","N00004032",115,61,24,37,2,36,6,30,12,11,1,4
"2011","N00004033 (Hawthorne ward)","N00004033",123,60,18,42,3,44,44,0,14,12,2,2
"2011","N00004034 (Hightown ward)","N00004034",119,75,46,29,3,2,1,1,39,36,3,0
"2011","N00004035 (Hightown ward)","N00004035",128,112,69,43,2,3,1,2,10,8,2,1
"2011","N00004036 (Hightown ward)","N00004036",117,86,30,56,2,5,0,5,24,22,2,0
"2011","N00004037 (Hightown ward)","N00004037",138,113,48,65,1,1,1,0,21,20,1,2
"2011","N00004038 (Hightown ward)","N00004038",123,82,42,40,3,19,5,14,17,17,0,2
"2011","N00004039 (Hightown ward)","N00004039",124,110,63,47,2,0,0,0,8,8,0,4
"2011","N00004040 (Hightown ward)","N00004040",121,110,57,53,0,2,2,0,7,6,1,2
"2011","N00004041 (Hightown ward)","N00004041",130,117,71,46,0,1,1,0,11,10,1,1
"2011","N00004042 (Jordanstown ward)","N00004042",220,204,102,102,0,3,3,0,11,9,2,2
"2011","N00004043 (Jordanstown ward)","N00004043",129,122,51,71,1,1,1,0,4,4,0,1
"2011","N00004044 (Jordanstown ward)","N00004044",133,102,53,49,0,17,1,16,7,7,0,7
"2011","N00004045 (Jordanstown ward)","N00004045",147,123,55,68,2,5,4,1,14,12,2,3
"2011","N00004046 (Jordanstown ward)","N00004046",125,84,42,42,3,19,19,0,15,15,0,4
"2011","N00004047 (Jordanstown ward)","N00004047",333,322,76,246,1,1,1,0,9,9,0,0
"2011","N00004048 (Jordanstown ward)","N00004048",151,141,38,103,0,1,1,0,9,6,3,0
"2011","N00004049 (Jordanstown ward)","N00004049",177,167,66,101,0,1,0,1,7,4,3,2
"2011","N00004050 (Jordanstown ward)","N00004050",351,319,132,187,0,4,4,0,26,23,3,2
"2011","N00004051 (Jordanstown ward)","N00004051",306,292,126,166,0,1,1,0,8,7,1,5
"2011","N00004052 (Jordanstown ward)","N00004052",132,119,74,45,0,1,1,0,10,8,2,2
"2011","N00004053 (Mallusk ward)","N00004053",121,106,51,55,0,2,2,0,10,10,0,3
"2011","N00004054 (Mallusk ward)","N00004054",183,166,71,95,1,1,1,0,12,11,1,3
"2011","N00004055 (Mallusk ward)","N00004055",104,71,37,34,0,21,20,1,11,10,1,1
"2011","N00004056 (Mallusk ward)","N00004056",138,130,38,92,0,1,0,1,7,6,1,0
"2011","N00004057 (Mallusk ward)","N00004057",134,122,61,61,0,1,0,1,10,8,2,1
"2011","N00004058 (Mallusk ward)","N00004058",447,391,101,290,3,3,2,1,46,41,5,4
"2011","N00004059 (Mallusk ward)","N00004059",544,489,53,436,7,6,2,4,40,39,1,2
"2011","N00004060 (Mallusk ward)","N00004060",459,382,33,349,11,1,1,0,64,56,8,1
"2011","N00004061 (Mallusk ward)","N00004061",195,178,13,165,0,0,0,0,17,15,2,0
"2011","N00004062 (Mallusk ward)","N00004062",143,131,49,82,0,1,1,0,6,6,0,5
"2011","N00004063 (Mallusk ward)","N00004063",306,268,115,153,0,4,4,0,29,26,3,5
"2011","N00004064 (Mallusk ward)","N00004064",200,186,57,129,1,1,1,0,10,9,1,2
"2011","N00004065 (Monkstown ward)","N00004065",124,32,12,20,1,75,74,1,9,7,2,7
"2011","N00004066 (Monkstown ward)","N00004066",125,74,29,45,1,36,36,0,9,8,1,5
"2011","N00004067 (Monkstown ward)","N00004067",116,47,19,28,0,57,57,0,8,7,1,4
"2011","N00004068 (Monkstown ward)","N00004068",127,66,28,38,0,49,47,2,11,10,1,1
"2011","N00004069 (Monkstown ward)","N00004069",109,44,14,30,0,47,47,0,14,13,1,4
"2011","N00004070 (Monkstown ward)","N00004070",110,66,40,26,0,25,25,0,18,15,3,1
"2011","N00004071 (Monkstown ward)","N00004071",135,45,19,26,1,79,78,1,6,5,1,4
"2011","N00004072 (Monkstown ward)","N00004072",119,71,26,45,0,33,33,0,9,8,1,6
"2011","N00004073 (Monkstown ward)","N00004073",373,284,43,241,4,25,24,1,58,55,3,2
"2011","N00004074 (Monkstown ward)","N00004074",143,108,24,84,2,18,17,1,13,11,2,2
"2011","N00004075 (Mossley ward)","N00004075",147,137,61,76,0,2,2,0,6,6,0,2
"2011","N00004076 (Mossley ward)","N00004076",128,89,21,68,0,13,13,0,19,18,1,7
"2011","N00004077 (Mossley ward)","N00004077",131,114,37,77,1,0,0,0,16,15,1,0
"2011","N00004078 (Mossley ward)","N00004078",132,106,49,57,2,8,8,0,14,14,0,2
"2011","N00004079 (Mossley ward)","N00004079",133,73,36,37,0,48,48,0,11,10,1,1
"2011","N00004080 (Mossley ward)","N00004080",129,43,8,35,2,67,65,2,9,5,4,8
"2011","N00004081 (Mossley ward)","N00004081",129,77,27,50,1,30,30,0,15,14,1,6
"2011","N00004082 (Mossley ward)","N00004082",165,91,18,73,4,50,50,0,15,13,2,5
"2011","N00004083 (Mossley ward)","N00004083",134,50,18,32,1,65,61,4,16,15,1,2
"2011","N00004084 (Rostulla ward)","N00004084",136,115,80,35,0,3,1,2,17,13,4,1
"2011","N00004085 (Rostulla ward)","N00004085",396,225,118,107,4,69,33,36,92,85,7,6
"2011","N00004086 (Rostulla ward)","N00004086",126,38,10,28,0,82,82,0,5,5,0,1
"2011","N00004087 (Rostulla ward)","N00004087",231,164,28,136,2,15,15,0,47,44,3,3
"2011","N00004088 (Rostulla ward)","N00004088",149,130,76,54,0,0,0,0,16,16,0,3
"2011","N00004089 (Rostulla ward)","N00004089",121,111,63,48,0,0,0,0,6,6,0,4
"2011","N00004090 (Rostulla ward)","N00004090",152,131,74,57,0,2,2,0,18,16,2,1
"2011","N00004091 (Rostulla ward)","N00004091",144,127,89,38,0,0,0,0,14,12,2,3
"2011","N00004092 (Valley ward)","N00004092",132,90,41,49,0,8,3,5,32,29,3,2
"2011","N00004093 (Valley ward)","N00004093",211,89,30,59,1,29,0,29,91,88,3,1
"2011","N00004094 (Valley ward)","N00004094",228,158,71,87,2,41,36,5,22,20,2,5
"2011","N00004095 (Valley ward)","N00004095",123,60,25,35,0,47,43,4,14,13,1,2
"2011","N00004096 (Valley ward)","N00004096",119,42,16,26,1,57,53,4,16,15,1,3
"2011","N00004097 (Valley ward)","N00004097",202,88,37,51,2,77,37,40,31,29,2,4
"2011","N00004098 (Valley ward)","N00004098",138,48,23,25,4,75,75,0,9,9,0,2
"2011","N00004099 (Valley ward)","N00004099",269,144,56,88,3,28,27,1,89,87,2,5
"2011","N00004100 (Valley ward)","N00004100",156,54,9,45,2,84,16,68,11,10,1,5
"2011","N00004101 (Whitehouse ward)","N00004101",124,38,14,24,1,65,49,16,12,10,2,8
"2011","N00004102 (Whitehouse ward)","N00004102",155,78,24,54,2,60,33,27,11,10,1,4
"2011","N00004103 (Whitehouse ward)","N00004103",113,26,11,15,0,77,77,0,5,4,1,5
"2011","N00004104 (Whitehouse ward)","N00004104",91,65,36,29,0,10,9,1,8,7,1,8
"2011","N00004105 (Whitehouse ward)","N00004105",153,25,16,9,1,113,112,1,7,6,1,7
"2011","N00004106 (Whitehouse ward)","N00004106",137,48,22,26,2,63,63,0,23,22,1,1
"2011","N00004107 (Whitehouse ward)","N00004107",111,75,43,32,1,24,22,2,10,9,1,1
"2011","N00004108 (Whitehouse ward)","N00004108",127,51,22,29,0,65,47,18,6,5,1,5
"2011","N00004109 (Whitehouse ward)","N00004109",126,92,57,35,1,24,23,1,6,5,1,3
"2011","N00000130 (Ballygowan ward)","N00000130",152,140,27,113,0,1,1,0,9,9,0,2
"2011","N00000131 (Ballygowan ward)","N00000131",136,126,71,55,0,2,2,0,7,5,2,1
"2011","N00000132 (Ballygowan ward)","N00000132",121,115,77,38,0,0,0,0,4,4,0,2
"2011","N00000133 (Ballygowan ward)","N00000133",139,102,55,47,1,22,20,2,9,9,0,5
"2011","N00000134 (Ballygowan ward)","N00000134",177,148,62,86,1,9,9,0,16,15,1,3
"2011","N00000135 (Ballygowan ward)","N00000135",119,80,35,45,0,33,33,0,2,2,0,4
"2011","N00000136 (Ballygowan ward)","N00000136",188,172,69,103,0,2,2,0,11,10,1,3
"2011","N00000137 (Ballygowan ward)","N00000137",120,111,48,63,1,1,1,0,4,3,1,3
"2011","N00000138 (Ballygowan ward)","N00000138",155,151,44,107,0,0,0,0,2,2,0,2
"2011","N00000139 (Ballyrainey ward)","N00000139",133,94,48,46,0,27,27,0,8,7,1,4
"2011","N00000140 (Ballyrainey ward)","N00000140",158,112,74,38,1,13,13,0,23,18,5,9
"2011","N00000141 (Ballyrainey ward)","N00000141",220,78,37,41,3,97,71,26,27,19,8,15
"2011","N00000142 (Ballyrainey ward)","N00000142",96,62,36,26,2,17,17,0,12,10,2,3
"2011","N00000143 (Ballyrainey ward)","N00000143",123,49,22,27,0,57,57,0,13,12,1,4
"2011","N00000144 (Ballyrainey ward)","N00000144",110,44,21,23,4,46,44,2,13,12,1,3
"2011","N00000145 (Ballyrainey ward)","N00000145",75,12,7,5,0,54,4,50,5,1,4,4
"2011","N00000146 (Ballyrainey ward)","N00000146",105,84,56,28,0,4,4,0,12,11,1,5
"2011","N00000147 (Ballyrainey ward)","N00000147",106,53,29,24,2,30,30,0,14,9,5,7
"2011","N00000148 (Ballywalter ward)","N00000148",279,156,61,95,5,46,29,17,70,66,4,2
"2011","N00000149 (Ballywalter ward)","N00000149",187,124,64,60,3,30,12,18,26,18,8,4
"2011","N00000150 (Ballywalter ward)","N00000150",149,141,78,63,1,3,2,1,4,4,0,0
"2011","N00000151 (Ballywalter ward)","N00000151",131,83,46,37,0,20,19,1,25,20,5,3
"2011","N00000152 (Ballywalter ward)","N00000152",131,54,19,35,1,58,57,1,12,11,1,6
"2011","N00000153 (Ballywalter ward)","N00000153",111,63,33,30,2,27,27,0,12,9,3,7
"2011","N00000154 (Ballywalter ward)","N00000154",108,81,41,40,1,11,11,0,9,8,1,6
"2011","N00000155 (Ballywalter ward)","N00000155",128,96,48,48,2,14,14,0,12,11,1,4
"2011","N00000156 (Ballywalter ward)","N00000156",127,124,62,62,0,1,1,0,2,2,0,0
"2011","N00000157 (Ballywalter ward)","N00000157",139,116,65,51,0,6,6,0,11,10,1,6
"2011","N00000158 (Ballywalter ward)","N00000158",286,222,140,82,7,5,5,0,44,41,3,8
"2011","N00000159 (Bradshaws Brae ward)","N00000159",116,58,32,26,0,32,32,0,23,22,1,3
"2011","N00000160 (Bradshaws Brae ward)","N00000160",124,79,45,34,1,19,19,0,19,16,3,6
"2011","N00000161 (Bradshaws Brae ward)","N00000161",128,121,79,42,0,1,1,0,5,5,0,1
"2011","N00000162 (Bradshaws Brae ward)","N00000162",115,96,47,49,0,2,2,0,14,12,2,3
"2011","N00000163 (Bradshaws Brae ward)","N00000163",155,60,27,33,2,55,30,25,32,29,3,6
"2011","N00000164 (Bradshaws Brae ward)","N00000164",118,110,72,38,0,0,0,0,4,3,1,4
"2011","N00000165 (Bradshaws Brae ward)","N00000165",135,115,63,52,0,5,4,1,11,9,2,4
"2011","N00000166 (Bradshaws Brae ward)","N00000166",122,112,78,34,0,1,0,1,8,6,2,1
"2011","N00000167 (Bradshaws Brae ward)","N00000167",149,133,75,58,4,0,0,0,8,7,1,4
"2011","N00000168 (Bradshaws Brae ward)","N00000168",145,135,80,55,1,2,2,0,5,5,0,2
"2011","N00000169 (Carrowdore ward)","N00000169",279,222,125,97,0,10,10,0,32,32,0,15
"2011","N00000170 (Carrowdore ward)","N00000170",139,108,50,58,3,14,4,10,12,12,0,2
"2011","N00000171 (Carrowdore ward)","N00000171",146,131,64,67,0,8,7,1,3,3,0,4
"2011","N00000172 (Carrowdore ward)","N00000172",307,273,131,142,0,5,5,0,25,20,5,4
"2011","N00000173 (Carrowdore ward)","N00000173",144,119,79,40,0,7,7,0,13,12,1,5
"2011","N00000174 (Carrowdore ward)","N00000174",163,72,24,48,3,59,59,0,22,20,2,7
"2011","N00000175 (Carrowdore ward)","N00000175",140,120,48,72,1,5,4,1,11,9,2,3
"2011","N00000176 (Central ward)","N00000176",205,124,76,48,3,32,32,0,40,36,4,6
"2011","N00000177 (Central ward)","N00000177",167,91,49,42,2,20,1,19,51,48,3,3
"2011","N00000178 (Central ward)","N00000178",355,154,77,77,4,110,54,56,67,61,6,20
"2011","N00000179 (Central ward)","N00000179",492,193,74,119,11,151,94,57,122,114,8,15
"2011","N00000180 (Central ward)","N00000180",131,61,30,31,1,56,56,0,9,9,0,4
"2011","N00000181 (Central ward)","N00000181",168,52,32,20,2,51,51,0,63,56,7,0
"2011","N00000182 (Comber East ward)","N00000182",105,69,39,30,1,21,18,3,8,7,1,6
"2011","N00000183 (Comber East ward)","N00000183",146,85,33,52,1,9,5,4,47,45,2,4
"2011","N00000184 (Comber East ward)","N00000184",184,85,41,44,3,26,0,26,63,57,6,7
"2011","N00000185 (Comber East ward)","N00000185",121,43,31,12,0,51,4,47,18,17,1,9
"2011","N00000186 (Comber East ward)","N00000186",137,53,31,22,1,57,22,35,22,20,2,4
"2011","N00000187 (Comber East ward)","N00000187",126,34,5,29,0,75,41,34,7,5,2,10
"2011","N00000188 (Comber East ward)","N00000188",128,86,37,49,0,32,31,1,5,4,1,5
"2011","N00000189 (Comber East ward)","N00000189",125,112,63,49,1,2,2,0,7,6,1,3
"2011","N00000190 (Comber East ward)","N00000190",119,110,61,49,1,0,0,0,6,6,0,2
"2011","N00000191 (Comber East ward)","N00000191",124,118,67,51,0,3,3,0,3,3,0,0
"2011","N00000192 (Comber North ward)","N00000192",120,94,37,57,1,11,11,0,13,12,1,1
"2011","N00000193 (Comber North ward)","N00000193",111,35,6,29,2,57,55,2,12,12,0,5
"2011","N00000194 (Comber North ward)","N00000194",119,70,30,40,1,32,32,0,10,9,1,6
"2011","N00000195 (Comber North ward)","N00000195",123,60,33,27,2,38,38,0,10,7,3,13
"2011","N00000196 (Comber North ward)","N00000196",116,29,10,19,0,67,67,0,7,7,0,13
"2011","N00000197 (Comber North ward)","N00000197",115,106,43,63,1,0,0,0,7,7,0,1
"2011","N00000198 (Comber North ward)","N00000198",110,97,45,52,3,0,0,0,8,8,0,2
"2011","N00000199 (Comber North ward)","N00000199",130,115,40,75,0,5,5,0,7,4,3,3
"2011","N00000200 (Comber North ward)","N00000200",124,110,47,63,1,1,1,0,11,10,1,1
"2011","N00000201 (Comber West ward)","N00000201",143,114,73,41,0,13,0,13,15,14,1,1
"2011","N00000202 (Comber West ward)","N00000202",132,123,74,49,0,0,0,0,5,3,2,4
"2011","N00000203 (Comber West ward)","N00000203",134,114,66,48,0,3,3,0,13,6,7,4
"2011","N00000204 (Comber West ward)","N00000204",152,120,62,58,0,1,1,0,30,29,1,1
"2011","N00000205 (Comber West ward)","N00000205",118,102,46,56,0,1,1,0,12,11,1,3
"2011","N00000206 (Comber West ward)","N00000206",212,118,54,64,3,15,12,3,71,68,3,5
"2011","N00000207 (Comber West ward)","N00000207",119,87,37,50,1,2,2,0,25,20,5,4
"2011","N00000208 (Comber West ward)","N00000208",121,116,61,55,1,0,0,0,4,4,0,0
"2011","N00000209 (Comber West ward)","N00000209",122,115,56,59,1,0,0,0,6,4,2,0
"2011","N00000210 (Donaghadee North ward)","N00000210",219,122,67,55,1,30,9,21,58,52,6,8
"2011","N00000211 (Donaghadee North ward)","N00000211",269,149,88,61,3,85,61,24,23,20,3,9
"2011","N00000212 (Donaghadee North ward)","N00000212",85,40,18,22,1,6,1,5,34,31,3,4
"2011","N00000213 (Donaghadee North ward)","N00000213",150,94,52,42,1,18,18,0,31,28,3,6
"2011","N00000214 (Donaghadee North ward)","N00000214",151,112,62,50,2,11,10,1,23,22,1,3
"2011","N00000215 (Donaghadee North ward)","N00000215",151,143,72,71,0,1,1,0,7,7,0,0
"2011","N00000216 (Donaghadee North ward)","N00000216",161,131,67,64,0,20,20,0,8,7,1,2
"2011","N00000217 (Donaghadee North ward)","N00000217",175,152,93,59,0,2,2,0,21,20,1,0
"2011","N00000218 (Donaghadee North ward)","N00000218",148,136,80,56,0,1,1,0,9,8,1,2
"2011","N00000219 (Donaghadee South ward)","N00000219",123,41,16,25,2,66,65,1,10,6,4,4
"2011","N00000220 (Donaghadee South ward)","N00000220",125,41,13,28,3,66,64,2,11,10,1,4
"2011","N00000221 (Donaghadee South ward)","N00000221",115,45,10,35,2,60,54,6,3,3,0,5
"2011","N00000222 (Donaghadee South ward)","N00000222",130,119,62,57,0,4,1,3,6,5,1,1
"2011","N00000223 (Donaghadee South ward)","N00000223",128,98,39,59,0,22,11,11,3,3,0,5
"2011","N00000224 (Donaghadee South ward)","N00000224",118,94,39,55,1,1,1,0,22,19,3,0
"2011","N00000225 (Donaghadee South ward)","N00000225",90,80,62,18,1,2,1,1,3,2,1,4
"2011","N00000226 (Donaghadee South ward)","N00000226",111,102,65,37,0,1,1,0,7,7,0,1
"2011","N00000227 (Donaghadee South ward)","N00000227",121,74,41,33,0,35,35,0,7,7,0,5
"2011","N00000228 (Donaghadee South ward)","N00000228",127,116,67,49,1,2,2,0,7,5,2,1
"2011","N00000229 (Donaghadee South ward)","N00000229",150,109,39,70,1,21,15,6,15,13,2,4
"2011","N00000230 (Glen ward)","N00000230",116,56,23,33,0,51,51,0,7,7,0,2
"2011","N00000231 (Glen ward)","N00000231",122,31,15,16,0,81,75,6,5,5,0,5
"2011","N00000232 (Glen ward)","N00000232",136,82,39,43,3,23,19,4,26,25,1,2
"2011","N00000233 (Glen ward)","N00000233",128,75,31,44,4,24,23,1,19,16,3,6
"2011","N00000234 (Glen ward)","N00000234",124,49,27,22,3,19,18,1,51,48,3,2
"2011","N00000235 (Glen ward)","N00000235",128,94,65,29,1,26,26,0,7,6,1,0
"2011","N00000236 (Glen ward)","N00000236",108,60,22,38,1,39,37,2,4,3,1,4
"2011","N00000237 (Glen ward)","N00000237",147,140,68,72,0,1,1,0,6,4,2,0
"2011","N00000238 (Glen ward)","N00000238",121,116,77,39,0,0,0,0,2,0,2,3
"2011","N00000239 (Gregstown ward)","N00000239",118,26,3,23,0,79,62,17,6,5,1,7
"2011","N00000240 (Gregstown ward)","N00000240",132,36,5,31,2,85,83,2,4,4,0,5
"2011","N00000241 (Gregstown ward)","N00000241",138,129,55,74,0,2,2,0,5,4,1,2
"2011","N00000242 (Gregstown ward)","N00000242",120,112,48,64,0,4,3,1,1,1,0,3
"2011","N00000243 (Gregstown ward)","N00000243",110,81,43,38,0,17,16,1,10,7,3,2
"2011","N00000244 (Gregstown ward)","N00000244",118,59,31,28,1,44,42,2,8,8,0,6
"2011","N00000245 (Gregstown ward)","N00000245",126,106,60,46,1,7,7,0,11,9,2,1
"2011","N00000246 (Gregstown ward)","N00000246",127,70,34,36,2,37,34,3,9,9,0,9
"2011","N00000247 (Gregstown ward)","N00000247",122,113,68,45,0,1,1,0,7,7,0,1
"2011","N00000248 (Gregstown ward)","N00000248",124,119,59,60,0,1,0,1,4,4,0,0
"2011","N00000249 (Gregstown ward)","N00000249",131,119,30,89,3,0,0,0,9,7,2,0
"2011","N00000250 (Gregstown ward)","N00000250",166,137,49,88,1,6,5,1,18,17,1,4
"2011","N00000251 (Gregstown ward)","N00000251",155,133,26,107,7,1,1,0,13,13,0,1
"2011","N00000252 (Killinchy ward)","N00000252",132,111,63,48,0,2,2,0,14,13,1,5
"2011","N00000253 (Killinchy ward)","N00000253",175,162,87,75,1,3,3,0,2,1,1,7
"2011","N00000254 (Killinchy ward)","N00000254",117,110,62,48,0,1,1,0,4,4,0,2
"2011","N00000255 (Killinchy ward)","N00000255",127,117,70,47,0,1,1,0,7,6,1,2
"2011","N00000256 (Killinchy ward)","N00000256",308,262,157,105,0,2,1,1,37,33,4,7
"2011","N00000257 (Killinchy ward)","N00000257",173,136,57,79,1,20,20,0,14,14,0,2
"2011","N00000258 (Killinchy ward)","N00000258",140,126,65,61,0,1,1,0,11,10,1,2
"2011","N00000259 (Kircubbin ward)","N00000259",161,138,75,63,0,6,6,0,13,10,3,4
"2011","N00000260 (Kircubbin ward)","N00000260",210,157,78,79,1,16,16,0,31,30,1,5
"2011","N00000261 (Kircubbin ward)","N00000261",179,164,89,75,0,2,2,0,7,6,1,6
"2011","N00000262 (Kircubbin ward)","N00000262",156,114,51,63,1,15,15,0,18,14,4,8
"2011","N00000263 (Kircubbin ward)","N00000263",110,67,34,33,1,7,7,0,34,32,2,1
"2011","N00000264 (Kircubbin ward)","N00000264",196,127,49,78,0,40,40,0,25,21,4,4
"2011","N00000265 (Kircubbin ward)","N00000265",149,87,43,44,0,25,24,1,34,30,4,3
"2011","N00000266 (Kircubbin ward)","N00000266",126,92,37,55,0,11,11,0,21,16,5,2
"2011","N00000267 (Lisbane ward)","N00000267",152,134,71,63,0,1,1,0,16,16,0,1
"2011","N00000268 (Lisbane ward)","N00000268",142,128,74,54,0,1,1,0,11,10,1,2
"2011","N00000269 (Lisbane ward)","N00000269",135,122,80,42,0,2,2,0,9,9,0,2
"2011","N00000270 (Lisbane ward)","N00000270",133,124,82,42,1,0,0,0,7,5,2,1
"2011","N00000271 (Lisbane ward)","N00000271",142,131,72,59,0,3,3,0,7,5,2,1
"2011","N00000272 (Lisbane ward)","N00000272",133,107,77,30,2,16,16,0,8,6,2,0
"2011","N00000273 (Lisbane ward)","N00000273",163,149,84,65,1,4,4,0,7,7,0,2
"2011","N00000274 (Lisbane ward)","N00000274",176,159,96,63,0,3,2,1,13,11,2,1
"2011","N00000275 (Loughries ward)","N00000275",126,114,51,63,2,1,1,0,9,8,1,0
"2011","N00000276 (Loughries ward)","N00000276",126,107,27,80,7,5,4,1,7,5,2,0
"2011","N00000277 (Loughries ward)","N00000277",117,100,23,77,2,4,3,1,11,9,2,0
"2011","N00000278 (Loughries ward)","N00000278",121,105,39,66,5,1,1,0,9,9,0,1
"2011","N00000279 (Loughries ward)","N00000279",83,56,9,47,5,1,1,0,20,19,1,1
"2011","N00000280 (Loughries ward)","N00000280",154,71,15,56,3,57,56,1,16,16,0,7
"2011","N00000281 (Loughries ward)","N00000281",117,104,65,39,0,7,7,0,5,5,0,1
"2011","N00000282 (Loughries ward)","N00000282",132,122,80,42,1,1,1,0,8,8,0,0
"2011","N00000283 (Loughries ward)","N00000283",142,127,58,69,0,4,4,0,11,9,2,0
"2011","N00000284 (Loughries ward)","N00000284",157,90,25,65,0,36,35,1,26,25,1,5
"2011","N00000285 (Loughries ward)","N00000285",124,47,11,36,2,63,63,0,7,7,0,5
"2011","N00000286 (Millisle ward)","N00000286",126,81,46,35,0,22,21,1,19,18,1,4
"2011","N00000287 (Millisle ward)","N00000287",137,57,25,32,1,38,26,12,36,34,2,5
"2011","N00000288 (Millisle ward)","N00000288",138,110,37,73,0,13,13,0,15,13,2,0
"2011","N00000289 (Millisle ward)","N00000289",197,154,54,100,1,10,5,5,26,24,2,6
"2011","N00000290 (Millisle ward)","N00000290",128,62,31,31,0,53,47,6,12,12,0,1
"2011","N00000291 (Millisle ward)","N00000291",204,174,74,100,3,4,4,0,21,17,4,2
"2011","N00000292 (Millisle ward)","N00000292",262,231,91,140,0,2,2,0,26,24,2,3
"2011","N00000293 (Millisle ward)","N00000293",162,153,33,120,0,0,0,0,8,8,0,1
"2011","N00000294 (Millisle ward)","N00000294",140,128,71,57,1,2,2,0,4,3,1,5
"2011","N00000295 (Millisle ward)","N00000295",144,127,66,61,1,0,0,0,15,14,1,1
"2011","N00000296 (Movilla ward)","N00000296",114,104,35,69,1,1,1,0,8,6,2,0
"2011","N00000297 (Movilla ward)","N00000297",128,118,60,58,0,0,0,0,9,8,1,1
"2011","N00000298 (Movilla ward)","N00000298",119,99,27,72,4,2,2,0,13,11,2,1
"2011","N00000299 (Movilla ward)","N00000299",147,121,68,53,3,0,0,0,19,16,3,4
"2011","N00000300 (Movilla ward)","N00000300",133,75,32,43,0,40,40,0,14,11,3,4
"2011","N00000301 (Movilla ward)","N00000301",124,119,23,96,0,0,0,0,4,2,2,1
"2011","N00000302 (Movilla ward)","N00000302",127,117,45,72,1,1,0,1,8,6,2,0
"2011","N00000303 (Movilla ward)","N00000303",110,102,39,63,0,1,1,0,7,6,1,0
"2011","N00000304 (Movilla ward)","N00000304",117,100,15,85,4,0,0,0,13,12,1,0
"2011","N00000305 (Movilla ward)","N00000305",121,116,32,84,0,1,1,0,4,4,0,0
"2011","N00000306 (Movilla ward)","N00000306",128,122,28,94,0,1,1,0,5,5,0,0
"2011","N00000307 (Movilla ward)","N00000307",122,113,37,76,0,2,2,0,6,5,1,1
"2011","N00000308 (Movilla ward)","N00000308",110,100,40,60,0,0,0,0,10,9,1,0
"2011","N00000309 (Movilla ward)","N00000309",124,108,27,81,0,1,1,0,14,13,1,1
"2011","N00000310 (Portaferry ward)","N00000310",149,132,89,43,0,7,7,0,9,8,1,1
"2011","N00000311 (Portaferry ward)","N00000311",160,96,54,42,0,29,24,5,31,29,2,4
"2011","N00000312 (Portaferry ward)","N00000312",175,134,65,69,0,11,8,3,26,21,5,4
"2011","N00000313 (Portaferry ward)","N00000313",193,159,54,105,4,3,2,1,21,19,2,6
"2011","N00000314 (Portaferry ward)","N00000314",137,77,32,45,2,31,29,2,20,18,2,7
"2011","N00000315 (Portaferry ward)","N00000315",133,69,33,36,0,31,24,7,25,21,4,8
"2011","N00000316 (Portaferry ward)","N00000316",130,101,43,58,0,8,8,0,20,18,2,1
"2011","N00000317 (Portaferry ward)","N00000317",213,90,48,42,0,70,60,10,37,32,5,16
"2011","N00000318 (Portavogie ward)","N00000318",129,106,52,54,3,6,6,0,10,9,1,4
"2011","N00000319 (Portavogie ward)","N00000319",310,243,91,152,2,16,16,0,41,30,11,8
"2011","N00000320 (Portavogie ward)","N00000320",128,112,65,47,1,6,6,0,8,8,0,1
"2011","N00000321 (Portavogie ward)","N00000321",211,153,58,95,4,28,24,4,25,21,4,1
"2011","N00000322 (Portavogie ward)","N00000322",154,101,41,60,1,30,29,1,19,17,2,3
"2011","N00000323 (Portavogie ward)","N00000323",163,148,78,70,0,1,1,0,10,9,1,4
"2011","N00000324 (Portavogie ward)","N00000324",151,124,68,56,0,2,2,0,18,15,3,7
"2011","N00000325 (Portavogie ward)","N00000325",198,170,73,97,0,9,8,1,19,12,7,0
"2011","N00000326 (Portavogie ward)","N00000326",377,290,92,198,4,16,16,0,62,56,6,5
"2011","N00000327 (Scrabo ward)","N00000327",130,72,16,56,1,46,44,2,11,11,0,0
"2011","N00000328 (Scrabo ward)","N00000328",126,61,21,40,1,52,51,1,10,10,0,2
"2011","N00000329 (Scrabo ward)","N00000329",137,82,28,54,1,46,43,3,6,5,1,2
"2011","N00000330 (Scrabo ward)","N00000330",203,168,37,131,1,4,4,0,28,25,3,2
"2011","N00000331 (Scrabo ward)","N00000331",233,130,21,109,0,83,82,1,11,11,0,9
"2011","N00000332 (Scrabo ward)","N00000332",124,45,18,27,0,65,62,3,13,12,1,1
"2011","N00000333 (Scrabo ward)","N00000333",125,50,12,38,0,61,61,0,10,10,0,4
"2011","N00000334 (Scrabo ward)","N00000334",116,40,14,26,3,64,63,1,7,7,0,2
"2011","N00000335 (Whitespots ward)","N00000335",136,115,72,43,1,4,3,1,12,10,2,4
"2011","N00000336 (Whitespots ward)","N00000336",131,125,79,46,0,1,1,0,5,4,1,0
"2011","N00000337 (Whitespots ward)","N00000337",120,116,69,47,0,0,0,0,3,2,1,1
"2011","N00000338 (Whitespots ward)","N00000338",129,120,72,48,0,0,0,0,8,7,1,1
"2011","N00000339 (Whitespots ward)","N00000339",122,107,61,46,0,1,1,0,13,13,0,1
"2011","N00000340 (Whitespots ward)","N00000340",138,124,73,51,1,0,0,0,12,12,0,1
"2011","N00000341 (Whitespots ward)","N00000341",130,126,63,63,0,1,1,0,2,1,1,1
"2011","N00000342 (Whitespots ward)","N00000342",133,119,33,86,2,0,0,0,11,11,0,1
"2011","N00000343 (Whitespots ward)","N00000343",122,108,50,58,3,1,1,0,9,9,0,1
"2011","N00004110 (Ballycrochan ward)","N00004110",134,107,36,71,14,0,0,0,11,11,0,2
"2011","N00004111 (Ballycrochan ward)","N00004111",133,127,63,64,0,0,0,0,3,3,0,3
"2011","N00004112 (Ballycrochan ward)","N00004112",142,138,50,88,0,0,0,0,3,2,1,1
"2011","N00004113 (Ballycrochan ward)","N00004113",224,202,82,120,2,4,4,0,16,15,1,0
"2011","N00004114 (Ballycrochan ward)","N00004114",117,104,27,77,2,1,0,1,10,9,1,0
"2011","N00004115 (Ballycrochan ward)","N00004115",127,114,21,93,2,1,0,1,10,9,1,0
"2011","N00004116 (Ballycrochan ward)","N00004116",215,205,45,160,0,3,1,2,7,7,0,0
"2011","N00004117 (Ballycrochan ward)","N00004117",149,142,29,113,0,1,1,0,4,4,0,2
"2011","N00004118 (Ballycrochan ward)","N00004118",122,112,44,68,1,0,0,0,9,8,1,0
"2011","N00004119 (Ballycrochan ward)","N00004119",127,114,34,80,2,2,1,1,9,8,1,0
"2011","N00004120 (Ballycrochan ward)","N00004120",100,74,19,55,2,5,2,3,19,17,2,0
"2011","N00004121 (Ballycrochan ward)","N00004121",129,111,21,90,2,0,0,0,12,12,0,4
"2011","N00004122 (Ballycrochan ward)","N00004122",130,121,34,87,1,2,1,1,5,4,1,1
"2011","N00004123 (Ballyholme ward)","N00004123",152,136,81,55,0,0,0,0,10,10,0,6
"2011","N00004124 (Ballyholme ward)","N00004124",132,107,55,52,0,0,0,0,25,24,1,0
"2011","N00004125 (Ballyholme ward)","N00004125",142,127,57,70,0,1,0,1,13,11,2,1
"2011","N00004126 (Ballyholme ward)","N00004126",125,103,57,46,0,1,1,0,20,17,3,1
"2011","N00004127 (Ballyholme ward)","N00004127",131,107,62,45,0,10,3,7,10,9,1,4
"2011","N00004128 (Ballyholme ward)","N00004128",144,122,63,59,0,1,1,0,20,19,1,1
"2011","N00004129 (Ballyholme ward)","N00004129",119,113,60,53,0,0,0,0,4,4,0,2
"2011","N00004130 (Ballyholme ward)","N00004130",121,102,55,47,0,0,0,0,16,16,0,3
"2011","N00004131 (Ballymaconnell ward)","N00004131",127,118,73,45,0,0,0,0,8,6,2,1
"2011","N00004132 (Ballymaconnell ward)","N00004132",129,122,62,60,0,0,0,0,6,6,0,1
"2011","N00004133 (Ballymaconnell ward)","N00004133",122,116,48,68,1,0,0,0,5,4,1,0
"2011","N00004134 (Ballymaconnell ward)","N00004134",120,116,61,55,0,0,0,0,4,4,0,0
"2011","N00004135 (Ballymaconnell ward)","N00004135",132,115,51,64,2,1,1,0,14,12,2,0
"2011","N00004136 (Ballymaconnell ward)","N00004136",146,140,75,65,0,2,2,0,2,2,0,2
"2011","N00004137 (Ballymaconnell ward)","N00004137",140,134,70,64,0,0,0,0,5,5,0,1
"2011","N00004138 (Ballymaconnell ward)","N00004138",141,122,31,91,2,0,0,0,17,14,3,0
"2011","N00004139 (Ballymagee ward)","N00004139",262,246,109,137,1,2,2,0,11,11,0,2
"2011","N00004140 (Ballymagee ward)","N00004140",149,139,48,91,0,0,0,0,10,9,1,0
"2011","N00004141 (Ballymagee ward)","N00004141",129,119,51,68,1,2,2,0,4,2,2,3
"2011","N00004142 (Ballymagee ward)","N00004142",123,114,40,74,0,0,0,0,9,9,0,0
"2011","N00004143 (Ballymagee ward)","N00004143",124,113,53,60,0,0,0,0,11,11,0,0
"2011","N00004144 (Ballymagee ward)","N00004144",238,192,63,129,13,0,0,0,33,31,2,0
"2011","N00004145 (Ballymagee ward)","N00004145",121,107,44,63,4,0,0,0,9,9,0,1
"2011","N00004146 (Ballymagee ward)","N00004146",130,115,30,85,2,0,0,0,12,12,0,1
"2011","N00004147 (Ballymagee ward)","N00004147",126,100,17,83,8,1,1,0,15,14,1,2
"2011","N00004148 (Bangor Castle ward)","N00004148",117,19,9,10,0,48,12,36,49,48,1,1
"2011","N00004149 (Bangor Castle ward)","N00004149",124,104,65,39,2,2,0,2,16,16,0,0
"2011","N00004150 (Bangor Castle ward)","N00004150",241,176,112,64,6,1,1,0,53,45,8,5
"2011","N00004151 (Bangor Castle ward)","N00004151",130,100,69,31,3,2,1,1,23,20,3,2
"2011","N00004152 (Bangor Castle ward)","N00004152",123,86,53,33,1,3,3,0,28,24,4,5
"2011","N00004153 (Bangor Castle ward)","N00004153",142,120,64,56,0,2,2,0,18,16,2,2
"2011","N00004154 (Bangor Castle ward)","N00004154",110,96,65,31,1,0,0,0,12,12,0,1
"2011","N00004155 (Bangor Castle ward)","N00004155",143,83,34,49,1,35,35,0,22,22,0,2
"2011","N00004156 (Bangor Castle ward)","N00004156",108,47,21,26,1,39,39,0,20,18,2,1
"2011","N00004157 (Bloomfield ward)","N00004157",187,137,74,63,1,8,4,4,40,38,2,1
"2011","N00004158 (Bloomfield ward)","N00004158",178,153,74,79,1,3,0,3,20,18,2,1
"2011","N00004159 (Bloomfield ward)","N00004159",66,17,6,11,0,31,1,30,16,12,4,2
"2011","N00004160 (Bloomfield ward)","N00004160",94,34,12,22,0,41,22,19,14,14,0,5
"2011","N00004161 (Bloomfield ward)","N00004161",119,57,18,39,4,45,43,2,11,9,2,2
"2011","N00004162 (Bloomfield ward)","N00004162",111,34,9,25,1,61,60,1,9,9,0,6
"2011","N00004163 (Bloomfield ward)","N00004163",136,127,45,82,0,2,2,0,7,7,0,0
"2011","N00004164 (Bloomfield ward)","N00004164",136,128,19,109,0,3,3,0,5,4,1,0
"2011","N00004165 (Bloomfield ward)","N00004165",142,114,15,99,4,3,3,0,19,19,0,2
"2011","N00004166 (Bloomfield ward)","N00004166",122,102,37,65,4,1,1,0,14,13,1,1
"2011","N00004167 (Bloomfield ward)","N00004167",189,85,27,58,6,50,36,14,42,38,4,6
"2011","N00004168 (Bloomfield ward)","N00004168",118,25,9,16,0,74,74,0,5,4,1,14
"2011","N00004169 (Broadway ward)","N00004169",128,119,57,62,1,0,0,0,8,8,0,0
"2011","N00004170 (Broadway ward)","N00004170",127,113,48,65,1,1,0,1,10,10,0,2
"2011","N00004171 (Broadway ward)","N00004171",131,119,85,34,0,0,0,0,11,9,2,1
"2011","N00004172 (Broadway ward)","N00004172",123,107,73,34,0,0,0,0,15,12,3,1
"2011","N00004173 (Broadway ward)","N00004173",124,91,52,39,2,0,0,0,30,27,3,1
"2011","N00004174 (Broadway ward)","N00004174",112,106,70,36,0,1,0,1,4,3,1,1
"2011","N00004175 (Broadway ward)","N00004175",108,96,50,46,1,1,1,0,7,6,1,3
"2011","N00004176 (Broadway ward)","N00004176",220,113,72,41,0,91,9,82,7,5,2,9
"2011","N00004177 (Broadway ward)","N00004177",86,41,18,23,0,35,4,31,6,5,1,4
"2011","N00004178 (Broadway ward)","N00004178",119,100,44,56,1,2,1,1,14,14,0,2
"2011","N00004179 (Bryansburn ward)","N00004179",160,144,86,58,0,0,0,0,14,9,5,2
"2011","N00004180 (Bryansburn ward)","N00004180",112,105,62,43,1,1,1,0,5,4,1,0
"2011","N00004181 (Bryansburn ward)","N00004181",104,91,48,43,0,0,0,0,11,11,0,2
"2011","N00004182 (Bryansburn ward)","N00004182",132,111,65,46,0,1,1,0,17,15,2,3
"2011","N00004183 (Bryansburn ward)","N00004183",83,4,2,2,0,5,1,4,73,71,2,1
"2011","N00004184 (Bryansburn ward)","N00004184",114,100,62,38,3,0,0,0,8,8,0,3
"2011","N00004185 (Bryansburn ward)","N00004185",327,297,189,108,2,4,2,2,22,21,1,2
"2011","N00004186 (Bryansburn ward)","N00004186",141,111,66,45,0,16,4,12,11,11,0,3
"2011","N00004187 (Churchill ward)","N00004187",175,107,61,46,0,45,4,41,20,18,2,3
"2011","N00004188 (Churchill ward)","N00004188",125,104,47,57,0,2,1,1,18,16,2,1
"2011","N00004189 (Churchill ward)","N00004189",114,100,75,25,0,2,2,0,10,7,3,2
"2011","N00004190 (Churchill ward)","N00004190",215,137,71,66,0,59,5,54,15,13,2,4
"2011","N00004191 (Churchill ward)","N00004191",261,218,108,110,1,10,3,7,27,23,4,5
"2011","N00004192 (Churchill ward)","N00004192",134,92,43,49,2,27,21,6,13,12,1,0
"2011","N00004193 (Churchill ward)","N00004193",122,105,63,42,1,1,1,0,15,10,5,0
"2011","N00004194 (Churchill ward)","N00004194",109,97,57,40,0,3,3,0,7,6,1,2
"2011","N00004195 (Clandeboye ward)","N00004195",115,70,18,52,3,32,32,0,10,10,0,0
"2011","N00004196 (Clandeboye ward)","N00004196",338,296,76,220,3,6,5,1,24,23,1,9
"2011","N00004197 (Clandeboye ward)","N00004197",112,22,4,18,1,75,75,0,11,11,0,3
"2011","N00004198 (Clandeboye ward)","N00004198",111,27,8,19,0,62,62,0,14,14,0,8
"2011","N00004199 (Clandeboye ward)","N00004199",293,222,55,167,10,8,8,0,50,48,2,3
"2011","N00004200 (Clandeboye ward)","N00004200",123,117,31,86,0,0,0,0,6,5,1,0
"2011","N00004201 (Clandeboye ward)","N00004201",123,100,27,73,4,3,3,0,16,13,3,0
"2011","N00004202 (Clandeboye ward)","N00004202",139,107,27,80,13,2,1,1,15,14,1,2
"2011","N00004203 (Clandeboye ward)","N00004203",119,81,18,63,6,16,16,0,14,12,2,2
"2011","N00004204 (Clandeboye ward)","N00004204",128,108,33,75,2,4,4,0,12,10,2,2
"2011","N00004205 (Clandeboye ward)","N00004205",118,88,28,60,3,12,11,1,14,13,1,1
"2011","N00004206 (Clandeboye ward)","N00004206",123,61,30,31,5,43,43,0,9,9,0,5
"2011","N00004207 (Conlig ward)","N00004207",133,102,44,58,0,23,22,1,4,3,1,4
"2011","N00004208 (Conlig ward)","N00004208",190,107,17,90,0,64,62,2,17,16,1,2
"2011","N00004209 (Conlig ward)","N00004209",231,194,59,135,0,11,2,9,23,18,5,3
"2011","N00004210 (Conlig ward)","N00004210",148,94,39,55,5,33,33,0,14,10,4,2
"2011","N00004211 (Conlig ward)","N00004211",296,233,45,188,9,17,17,0,36,35,1,1
"2011","N00004212 (Conlig ward)","N00004212",756,606,119,487,18,21,9,12,104,90,14,7
"2011","N00004213 (Conlig ward)","N00004213",149,38,5,33,5,90,36,54,8,6,2,8
"2011","N00004214 (Conlig ward)","N00004214",145,34,7,27,2,91,84,7,11,11,0,7
"2011","N00004215 (Conlig ward)","N00004215",119,94,13,81,4,7,5,2,12,12,0,2
"2011","N00004216 (Conlig ward)","N00004216",210,80,9,71,7,91,87,4,21,20,1,11
"2011","N00004217 (Conlig ward)","N00004217",129,34,7,27,3,87,80,7,4,3,1,1
"2011","N00004218 (Conlig ward)","N00004218",115,54,15,39,2,45,27,18,12,10,2,2
"2011","N00004219 (Craigavad ward)","N00004219",124,107,65,42,0,1,1,0,15,14,1,1
"2011","N00004220 (Craigavad ward)","N00004220",122,96,64,32,0,12,11,1,9,9,0,5
"2011","N00004221 (Craigavad ward)","N00004221",129,115,74,41,1,2,2,0,10,9,1,1
"2011","N00004222 (Craigavad ward)","N00004222",136,126,62,64,0,3,2,1,5,4,1,2
"2011","N00004223 (Craigavad ward)","N00004223",107,81,45,36,0,6,4,2,16,16,0,4
"2011","N00004224 (Craigavad ward)","N00004224",127,109,72,37,1,1,1,0,13,12,1,3
"2011","N00004225 (Craigavad ward)","N00004225",116,112,72,40,1,0,0,0,3,3,0,0
"2011","N00004226 (Craigavad ward)","N00004226",141,109,62,47,0,6,5,1,20,19,1,6
"2011","N00004227 (Crawfordsburn ward)","N00004227",114,107,59,48,0,0,0,0,5,5,0,2
"2011","N00004228 (Crawfordsburn ward)","N00004228",306,250,135,115,0,12,12,0,33,31,2,11
"2011","N00004229 (Crawfordsburn ward)","N00004229",137,114,67,47,0,5,2,3,17,16,1,1
"2011","N00004230 (Crawfordsburn ward)","N00004230",120,114,78,36,0,1,1,0,4,4,0,1
"2011","N00004231 (Crawfordsburn ward)","N00004231",126,122,78,44,0,0,0,0,4,3,1,0
"2011","N00004232 (Crawfordsburn ward)","N00004232",117,110,81,29,0,0,0,0,6,6,0,1
"2011","N00004233 (Crawfordsburn ward)","N00004233",138,126,76,50,0,1,0,1,10,8,2,1
"2011","N00004234 (Crawfordsburn ward)","N00004234",118,114,77,37,0,0,0,0,4,4,0,0
"2011","N00004235 (Cultra ward)","N00004235",113,112,62,50,0,0,0,0,1,1,0,0
"2011","N00004236 (Cultra ward)","N00004236",113,96,71,25,0,0,0,0,14,13,1,3
"2011","N00004237 (Cultra ward)","N00004237",114,104,64,40,0,0,0,0,9,8,1,1
"2011","N00004238 (Cultra ward)","N00004238",134,111,60,51,1,1,1,0,19,18,1,2
"2011","N00004239 (Cultra ward)","N00004239",117,114,77,37,0,0,0,0,2,1,1,1
"2011","N00004240 (Cultra ward)","N00004240",118,107,58,49,0,2,1,1,8,7,1,1
"2011","N00004241 (Cultra ward)","N00004241",116,108,60,48,1,0,0,0,6,6,0,1
"2011","N00004242 (Cultra ward)","N00004242",130,117,77,40,0,1,1,0,11,11,0,1
"2011","N00004243 (Dufferin ward)","N00004243",127,73,27,46,2,42,42,0,7,7,0,3
"2011","N00004244 (Dufferin ward)","N00004244",93,35,15,20,1,46,45,1,7,7,0,4
"2011","N00004245 (Dufferin ward)","N00004245",177,98,32,66,2,45,45,0,30,28,2,2
"2011","N00004246 (Dufferin ward)","N00004246",130,108,57,51,1,3,3,0,18,18,0,0
"2011","N00004247 (Dufferin ward)","N00004247",131,116,62,54,2,3,3,0,9,9,0,1
"2011","N00004248 (Dufferin ward)","N00004248",134,44,20,24,2,74,71,3,9,9,0,5
"2011","N00004249 (Dufferin ward)","N00004249",144,76,36,40,1,48,48,0,11,9,2,8
"2011","N00004250 (Dufferin ward)","N00004250",117,55,16,39,4,36,36,0,18,15,3,4
"2011","N00004251 (Dufferin ward)","N00004251",139,47,12,35,8,66,66,0,14,13,1,4
"2011","N00004252 (Groomsport ward)","N00004252",121,116,71,45,1,0,0,0,3,2,1,1
"2011","N00004253 (Groomsport ward)","N00004253",121,112,72,40,0,0,0,0,9,9,0,0
"2011","N00004254 (Groomsport ward)","N00004254",118,104,63,41,0,4,4,0,9,6,3,1
"2011","N00004255 (Groomsport ward)","N00004255",105,99,66,33,0,0,0,0,5,4,1,1
"2011","N00004256 (Groomsport ward)","N00004256",402,360,230,130,3,1,1,0,34,30,4,4
"2011","N00004257 (Groomsport ward)","N00004257",128,106,89,17,0,3,3,0,16,13,3,3
"2011","N00004258 (Groomsport ward)","N00004258",151,88,49,39,2,34,16,18,20,17,3,7
"2011","N00004259 (Groomsport ward)","N00004259",108,60,35,25,1,26,26,0,15,14,1,6
"2011","N00004260 (Groomsport ward)","N00004260",138,126,82,44,0,0,0,0,8,7,1,4
"2011","N00004261 (Harbour ward)","N00004261",125,93,49,44,0,7,2,5,23,19,4,2
"2011","N00004262 (Harbour ward)","N00004262",123,49,16,33,0,2,0,2,72,67,5,0
"2011","N00004263 (Harbour ward)","N00004263",117,49,26,23,1,11,1,10,54,51,3,2
"2011","N00004264 (Harbour ward)","N00004264",300,118,55,63,2,3,2,1,173,169,4,4
"2011","N00004265 (Harbour ward)","N00004265",98,40,19,21,1,1,1,0,55,53,2,1
"2011","N00004266 (Harbour ward)","N00004266",129,108,51,57,0,4,1,3,16,12,4,1
"2011","N00004267 (Harbour ward)","N00004267",257,182,96,86,1,1,1,0,70,66,4,3
"2011","N00004268 (Harbour ward)","N00004268",136,96,46,50,0,8,4,4,27,23,4,5
"2011","N00004269 (Harbour ward)","N00004269",140,86,34,52,2,4,4,0,47,42,5,1
"2011","N00004270 (Holywood Demesne ward)","N00004270",149,101,50,51,0,9,9,0,36,33,3,3
"2011","N00004271 (Holywood Demesne ward)","N00004271",138,71,32,39,1,32,32,0,26,23,3,8
"2011","N00004272 (Holywood Demesne ward)","N00004272",116,64,27,37,1,1,1,0,50,48,2,0
"2011","N00004273 (Holywood Demesne ward)","N00004273",253,99,64,35,2,101,17,84,43,36,7,8
"2011","N00004274 (Holywood Demesne ward)","N00004274",129,83,27,56,1,16,16,0,26,23,3,3
"2011","N00004275 (Holywood Demesne ward)","N00004275",143,92,38,54,0,6,6,0,44,42,2,1
"2011","N00004276 (Holywood Demesne ward)","N00004276",179,143,87,56,1,1,1,0,32,28,4,2
"2011","N00004277 (Holywood Demesne ward)","N00004277",120,108,62,46,0,1,0,1,10,9,1,1
"2011","N00004278 (Holywood Demesne ward)","N00004278",121,77,41,36,0,33,33,0,8,6,2,3
"2011","N00004279 (Holywood Priory ward)","N00004279",137,117,74,43,2,0,0,0,17,17,0,1
"2011","N00004280 (Holywood Priory ward)","N00004280",127,98,57,41,0,2,0,2,25,21,4,2
"2011","N00004281 (Holywood Priory ward)","N00004281",168,145,76,69,0,1,1,0,18,16,2,4
"2011","N00004282 (Holywood Priory ward)","N00004282",154,48,30,18,1,87,60,27,11,9,2,7
"2011","N00004283 (Holywood Priory ward)","N00004283",133,106,45,61,0,16,15,1,10,10,0,1
"2011","N00004284 (Holywood Priory ward)","N00004284",150,138,79,59,0,2,1,1,9,6,3,1
"2011","N00004285 (Holywood Priory ward)","N00004285",118,113,68,45,0,0,0,0,5,5,0,0
"2011","N00004286 (Holywood Priory ward)","N00004286",119,113,64,49,0,0,0,0,4,4,0,2
"2011","N00004287 (Loughview ward)","N00004287",253,137,55,82,4,80,78,2,23,12,11,9
"2011","N00004288 (Loughview ward)","N00004288",112,47,14,33,0,54,44,10,9,9,0,2
"2011","N00004289 (Loughview ward)","N00004289",111,42,16,26,3,53,33,20,12,9,3,1
"2011","N00004290 (Loughview ward)","N00004290",269,182,88,94,3,55,55,0,21,17,4,8
"2011","N00004292 (Loughview ward)","N00004292",91,46,19,27,2,32,32,0,9,2,7,2
"2011","N00004293 (Loughview ward)","N00004293",134,78,51,27,6,1,0,1,47,38,9,2
"2011","N00004294 (Loughview ward)","N00004294",229,25,12,13,0,10,5,5,191,18,173,3
"2011","N00004295 (Princetown ward)","N00004295",130,123,92,31,1,0,0,0,6,5,1,0
"2011","N00004296 (Princetown ward)","N00004296",136,106,65,41,0,7,1,6,21,18,3,2
"2011","N00004297 (Princetown ward)","N00004297",147,97,48,49,0,14,1,13,33,31,2,3
"2011","N00004298 (Princetown ward)","N00004298",134,127,62,65,0,1,0,1,5,5,0,1
"2011","N00004299 (Princetown ward)","N00004299",196,163,79,84,0,13,1,12,19,17,2,1
"2011","N00004300 (Princetown ward)","N00004300",110,64,52,12,0,32,0,32,12,9,3,2
"2011","N00004301 (Princetown ward)","N00004301",150,129,79,50,0,0,0,0,20,19,1,1
"2011","N00004302 (Princetown ward)","N00004302",173,145,97,48,0,14,0,14,13,12,1,1
"2011","N00004303 (Rathgael ward)","N00004303",103,95,39,56,1,0,0,0,7,7,0,0
"2011","N00004304 (Rathgael ward)","N00004304",121,112,69,43,0,1,0,1,8,8,0,0
"2011","N00004305 (Rathgael ward)","N00004305",103,94,46,48,1,1,1,0,7,6,1,0
"2011","N00004306 (Rathgael ward)","N00004306",207,123,51,72,0,2,1,1,77,71,6,5
"2011","N00004307 (Rathgael ward)","N00004307",132,87,36,51,1,3,1,2,39,38,1,2
"2011","N00004308 (Rathgael ward)","N00004308",119,93,39,54,6,6,0,6,12,12,0,2
"2011","N00004309 (Rathgael ward)","N00004309",118,106,70,36,0,1,0,1,9,8,1,2
"2011","N00004310 (Rathgael ward)","N00004310",107,100,55,45,0,0,0,0,6,6,0,1
"2011","N00004311 (Silverstream ward)","N00004311",122,74,30,44,3,2,0,2,42,35,7,1
"2011","N00004312 (Silverstream ward)","N00004312",123,102,40,62,4,1,1,0,13,13,0,3
"2011","N00004313 (Silverstream ward)","N00004313",118,77,18,59,13,1,1,0,27,24,3,0
"2011","N00004314 (Silverstream ward)","N00004314",304,191,57,134,7,16,11,5,88,83,5,2
"2011","N00004315 (Silverstream ward)","N00004315",110,43,17,26,0,40,39,1,23,22,1,4
"2011","N00004316 (Silverstream ward)","N00004316",115,88,29,59,13,1,0,1,13,12,1,0
"2011","N00004317 (Silverstream ward)","N00004317",127,95,38,57,5,1,1,0,23,19,4,3
"2011","N00004318 (Silverstream ward)","N00004318",107,95,36,59,1,2,1,1,9,9,0,0
"2011","N00004319 (Silverstream ward)","N00004319",127,89,36,53,2,0,0,0,35,33,2,1
"2011","N00004320 (Silverstream ward)","N00004320",198,89,35,54,3,53,5,48,50,42,8,3
"2011","N00004321 (Spring Hill ward)","N00004321",255,235,144,91,2,2,1,1,14,13,1,2
"2011","N00004322 (Spring Hill ward)","N00004322",136,114,61,53,1,4,3,1,17,14,3,0
"2011","N00004323 (Spring Hill ward)","N00004323",149,127,55,72,3,1,1,0,16,13,3,2
"2011","N00004324 (Spring Hill ward)","N00004324",131,75,46,29,0,5,1,4,51,49,2,0
"2011","N00004325 (Spring Hill ward)","N00004325",127,110,62,48,2,1,0,1,11,10,1,3
"2011","N00004326 (Spring Hill ward)","N00004326",136,126,76,50,0,1,1,0,8,7,1,1
"2011","N00004327 (Spring Hill ward)","N00004327",131,118,68,50,0,0,0,0,12,11,1,1
"2011","N00004328 (Spring Hill ward)","N00004328",119,111,61,50,2,0,0,0,6,6,0,0
"2011","N00004329 (Whitehill ward)","N00004329",117,65,22,43,4,32,31,1,14,12,2,2
"2011","N00004330 (Whitehill ward)","N00004330",115,101,45,56,0,3,3,0,11,10,1,0
"2011","N00004331 (Whitehill ward)","N00004331",126,101,47,54,2,2,2,0,18,17,1,3
"2011","N00004332 (Whitehill ward)","N00004332",133,106,60,46,2,2,2,0,21,17,4,2
"2011","N00004333 (Whitehill ward)","N00004333",133,66,37,29,2,41,27,14,20,17,3,4
"2011","N00004334 (Whitehill ward)","N00004334",111,39,16,23,1,54,52,2,7,6,1,10
"2011","N00004335 (Whitehill ward)","N00004335",126,44,24,20,1,63,56,7,11,9,2,7
"2011","N00004336 (Whitehill ward)","N00004336",122,60,19,41,1,45,45,0,10,8,2,6
"2011","N00004337 (Whitehill ward)","N00004337",113,54,26,28,3,40,40,0,10,8,2,6
"2011","N00000344 (Abbey Park ward)","N00000344",128,65,29,36,0,27,27,0,34,33,1,2
"2011","N00000345 (Abbey Park ward)","N00000345",163,93,50,43,0,31,31,0,37,35,2,2
"2011","N00000346 (Abbey Park ward)","N00000346",209,153,43,110,1,0,0,0,50,47,3,5
"2011","N00000347 (Abbey Park ward)","N00000347",130,63,40,23,1,30,30,0,30,28,2,6
"2011","N00000348 (Abbey Park ward)","N00000348",125,91,47,44,0,1,1,0,32,30,2,1
"2011","N00000349 (Abbey Park ward)","N00000349",149,113,54,59,0,7,7,0,28,25,3,1
"2011","N00000350 (Ballymartrim ward)","N00000350",169,139,61,78,0,16,7,9,12,9,3,2
"2011","N00000351 (Ballymartrim ward)","N00000351",137,112,62,50,0,5,5,0,17,15,2,3
"2011","N00000352 (Ballymartrim ward)","N00000352",142,123,64,59,0,1,1,0,13,10,3,5
"2011","N00000353 (Ballymartrim ward)","N00000353",140,117,71,46,0,1,1,0,14,11,3,8
"2011","N00000354 (Ballymartrim ward)","N00000354",133,121,70,51,0,0,0,0,9,6,3,3
"2011","N00000355 (Ballymartrim ward)","N00000355",154,129,90,39,0,3,1,2,18,10,8,4
"2011","N00000356 (Callan Bridge ward)","N00000356",146,63,15,48,4,46,46,0,28,25,3,5
"2011","N00000357 (Callan Bridge ward)","N00000357",452,204,78,126,3,91,88,3,149,134,15,5
"2011","N00000358 (Callan Bridge ward)","N00000358",140,58,26,32,0,48,48,0,28,25,3,6
"2011","N00000359 (Callan Bridge ward)","N00000359",389,125,75,50,1,140,85,55,109,102,7,14
"2011","N00000360 (Carrigatuke ward)","N00000360",130,113,60,53,0,2,2,0,11,8,3,4
"2011","N00000361 (Carrigatuke ward)","N00000361",148,87,49,38,0,24,24,0,31,28,3,6
"2011","N00000362 (Carrigatuke ward)","N00000362",126,107,66,41,0,2,2,0,11,8,3,6
"2011","N00000363 (Carrigatuke ward)","N00000363",150,142,76,66,0,2,2,0,1,1,0,5
"2011","N00000364 (Carrigatuke ward)","N00000364",150,135,90,45,0,2,2,0,9,7,2,4
"2011","N00000365 (Carrigatuke ward)","N00000365",86,62,37,25,0,12,12,0,11,7,4,1
"2011","N00000366 (Charlemont ward)","N00000366",187,132,53,79,1,16,14,2,32,30,2,6
"2011","N00000367 (Charlemont ward)","N00000367",143,96,57,39,1,14,10,4,30,26,4,2
"2011","N00000368 (Charlemont ward)","N00000368",170,158,88,70,0,1,1,0,6,4,2,5
"2011","N00000369 (Charlemont ward)","N00000369",141,122,79,43,0,3,0,3,13,9,4,3
"2011","N00000370 (Charlemont ward)","N00000370",172,139,78,61,0,2,2,0,22,18,4,9
"2011","N00000371 (Charlemont ward)","N00000371",141,123,70,53,1,2,2,0,12,9,3,3
"2011","N00000372 (Demesne ward)","N00000372",135,114,39,75,0,0,0,0,20,16,4,1
"2011","N00000373 (Demesne ward)","N00000373",178,137,68,69,0,1,1,0,36,32,4,4
"2011","N00000374 (Demesne ward)","N00000374",132,116,49,67,0,2,1,1,14,12,2,0
"2011","N00000375 (Demesne ward)","N00000375",134,114,82,32,0,0,0,0,16,14,2,4
"2011","N00000376 (Demesne ward)","N00000376",116,99,54,45,1,2,2,0,13,12,1,1
"2011","N00000377 (Demesne ward)","N00000377",119,101,68,33,0,1,1,0,12,11,1,5
"2011","N00000378 (Demesne ward)","N00000378",118,46,15,31,1,46,43,3,23,23,0,2
"2011","N00000379 (Demesne ward)","N00000379",164,142,44,98,1,0,0,0,19,18,1,2
"2011","N00000380 (Derrynoose ward)","N00000380",168,151,78,73,0,2,1,1,13,10,3,2
"2011","N00000381 (Derrynoose ward)","N00000381",333,185,64,121,0,68,18,50,72,65,7,8
"2011","N00000382 (Derrynoose ward)","N00000382",183,155,89,66,0,1,1,0,21,19,2,6
"2011","N00000383 (Derrynoose ward)","N00000383",144,121,81,40,0,12,11,1,7,5,2,4
"2011","N00000384 (Derrynoose ward)","N00000384",145,122,68,54,0,2,1,1,16,16,0,5
"2011","N00000385 (Derrynoose ward)","N00000385",135,124,69,55,0,0,0,0,9,6,3,2
"2011","N00000386 (Downs ward)","N00000386",125,64,30,34,3,22,20,2,29,27,2,7
"2011","N00000387 (Downs ward)","N00000387",106,74,44,30,0,14,13,1,15,14,1,3
"2011","N00000388 (Downs ward)","N00000388",603,322,147,175,2,125,84,41,138,120,18,16
"2011","N00000389 (Downs ward)","N00000389",156,108,41,67,0,24,24,0,19,17,2,5
"2011","N00000390 (Hamiltonsbawn ward)","N00000390",321,290,159,131,0,0,0,0,20,16,4,11
"2011","N00000391 (Hamiltonsbawn ward)","N00000391",173,159,89,70,0,0,0,0,9,8,1,5
"2011","N00000392 (Hamiltonsbawn ward)","N00000392",518,395,167,228,2,29,29,0,85,73,12,7
"2011","N00000393 (Hamiltonsbawn ward)","N00000393",178,147,89,58,0,2,2,0,22,20,2,7
"2011","N00000394 (Hockley ward)","N00000394",141,125,85,40,0,0,0,0,13,11,2,3
"2011","N00000395 (Hockley ward)","N00000395",142,122,81,41,0,2,2,0,15,13,2,3
"2011","N00000396 (Hockley ward)","N00000396",134,120,82,38,1,1,0,1,6,6,0,6
"2011","N00000397 (Hockley ward)","N00000397",189,158,77,81,0,2,2,0,26,21,5,3
"2011","N00000398 (Hockley ward)","N00000398",165,143,72,71,0,5,5,0,14,13,1,3
"2011","N00000399 (Hockley ward)","N00000399",130,92,51,41,0,14,14,0,19,19,0,5
"2011","N00000400 (Keady ward)","N00000400",112,53,31,22,3,32,32,0,15,13,2,9
"2011","N00000401 (Keady ward)","N00000401",117,76,43,33,0,19,18,1,18,15,3,4
"2011","N00000402 (Keady ward)","N00000402",123,69,50,19,2,9,9,0,40,33,7,3
"2011","N00000403 (Keady ward)","N00000403",208,140,76,64,1,10,10,0,48,45,3,9
"2011","N00000404 (Keady ward)","N00000404",121,77,46,31,0,16,15,1,21,18,3,7
"2011","N00000405 (Keady ward)","N00000405",105,43,21,22,1,29,29,0,28,25,3,4
"2011","N00000406 (Killeen ward)","N00000406",121,108,67,41,1,4,4,0,3,2,1,5
"2011","N00000407 (Killeen ward)","N00000407",344,293,151,142,0,15,15,0,27,22,5,9
"2011","N00000408 (Killeen ward)","N00000408",146,133,89,44,0,1,1,0,4,4,0,8
"2011","N00000409 (Killeen ward)","N00000409",143,112,64,48,0,14,14,0,12,12,0,5
"2011","N00000410 (Killeen ward)","N00000410",136,125,92,33,0,0,0,0,6,3,3,5
"2011","N00000411 (Killylea ward)","N00000411",128,96,53,43,0,18,10,8,12,10,2,2
"2011","N00000412 (Killylea ward)","N00000412",138,120,72,48,1,4,4,0,9,7,2,4
"2011","N00000413 (Killylea ward)","N00000413",131,121,67,54,0,1,1,0,6,5,1,3
"2011","N00000414 (Killylea ward)","N00000414",125,107,62,45,0,5,5,0,9,8,1,4
"2011","N00000415 (Killylea ward)","N00000415",162,114,63,51,0,22,22,0,20,18,2,6
"2011","N00000416 (Killylea ward)","N00000416",133,118,68,50,0,0,0,0,12,12,0,3
"2011","N00000417 (Laurelvale ward)","N00000417",187,158,46,112,2,0,0,0,26,23,3,1
"2011","N00000418 (Laurelvale ward)","N00000418",313,247,116,131,0,15,15,0,47,44,3,4
"2011","N00000419 (Laurelvale ward)","N00000419",139,118,74,44,0,2,2,0,14,10,4,5
"2011","N00000420 (Laurelvale ward)","N00000420",138,121,74,47,0,4,4,0,9,6,3,4
"2011","N00000421 (Laurelvale ward)","N00000421",185,163,59,104,1,1,1,0,18,16,2,2
"2011","N00000422 (Laurelvale ward)","N00000422",170,116,63,53,0,22,22,0,28,27,1,4
"2011","N00000423 (Loughgall ward)","N00000423",152,138,78,60,0,0,0,0,11,10,1,3
"2011","N00000424 (Loughgall ward)","N00000424",180,137,67,70,1,13,13,0,25,21,4,4
"2011","N00000425 (Loughgall ward)","N00000425",121,110,50,60,0,1,1,0,5,4,1,5
"2011","N00000426 (Loughgall ward)","N00000426",123,80,49,31,1,17,17,0,20,17,3,5
"2011","N00000427 (Loughgall ward)","N00000427",133,95,51,44,3,13,7,6,20,16,4,2
"2011","N00000428 (Loughgall ward)","N00000428",146,115,54,61,0,17,16,1,10,9,1,4
"2011","N00000429 (Loughgall ward)","N00000429",152,126,75,51,0,0,0,0,19,15,4,7
"2011","N00000430 (Markethill ward)","N00000430",154,143,92,51,0,1,1,0,8,7,1,2
"2011","N00000431 (Markethill ward)","N00000431",137,97,51,46,0,21,21,0,17,15,2,2
"2011","N00000432 (Markethill ward)","N00000432",118,74,43,31,0,25,24,1,11,9,2,8
"2011","N00000433 (Markethill ward)","N00000433",141,60,38,22,1,30,25,5,42,41,1,8
"2011","N00000434 (Markethill ward)","N00000434",179,100,55,45,0,28,27,1,41,39,2,10
"2011","N00000435 (Markethill ward)","N00000435",173,97,38,59,1,30,30,0,36,34,2,9
"2011","N00000436 (Markethill ward)","N00000436",174,148,84,64,1,0,0,0,23,23,0,2
"2011","N00000437 (Milford ward)","N00000437",195,179,66,113,0,0,0,0,14,13,1,2
"2011","N00000438 (Milford ward)","N00000438",153,143,78,65,0,0,0,0,4,3,1,6
"2011","N00000439 (Milford ward)","N00000439",134,116,73,43,0,0,0,0,12,10,2,6
"2011","N00000440 (Milford ward)","N00000440",127,103,54,49,0,5,5,0,13,12,1,6
"2011","N00000441 (Milford ward)","N00000441",121,97,57,40,0,0,0,0,22,22,0,2
"2011","N00000442 (Milford ward)","N00000442",167,118,53,65,1,2,1,1,44,40,4,2
"2011","N00000443 (Observatory ward)","N00000443",164,138,60,78,0,2,1,1,19,18,1,5
"2011","N00000444 (Observatory ward)","N00000444",257,131,80,51,1,62,44,18,54,47,7,9
"2011","N00000445 (Observatory ward)","N00000445",141,122,65,57,0,2,1,1,14,13,1,3
"2011","N00000446 (Observatory ward)","N00000446",130,109,54,55,0,3,3,0,16,16,0,2
"2011","N00000447 (Observatory ward)","N00000447",117,86,62,24,0,13,13,0,12,11,1,6
"2011","N00000448 (Observatory ward)","N00000448",128,40,29,11,1,48,43,5,27,27,0,12
"2011","N00000449 (Poyntz Pass ward)","N00000449",146,135,86,49,0,1,1,0,7,5,2,3
"2011","N00000450 (Poyntz Pass ward)","N00000450",178,147,73,74,0,5,2,3,20,20,0,6
"2011","N00000451 (Poyntz Pass ward)","N00000451",189,128,49,79,0,13,13,0,42,38,4,6
"2011","N00000452 (Poyntz Pass ward)","N00000452",157,134,81,53,0,4,4,0,13,11,2,6
"2011","N00000453 (Poyntz Pass ward)","N00000453",149,70,46,24,0,62,53,9,10,9,1,7
"2011","N00000454 (Poyntz Pass ward)","N00000454",162,145,80,65,1,2,1,1,11,9,2,3
"2011","N00000455 (Rich Hill ward)","N00000455",111,71,35,36,1,17,16,1,19,17,2,3
"2011","N00000456 (Rich Hill ward)","N00000456",118,106,53,53,0,2,1,1,5,4,1,5
"2011","N00000457 (Rich Hill ward)","N00000457",126,112,51,61,1,0,0,0,12,12,0,1
"2011","N00000458 (Rich Hill ward)","N00000458",129,121,77,44,0,0,0,0,7,4,3,1
"2011","N00000459 (Rich Hill ward)","N00000459",247,190,79,111,2,18,4,14,35,34,1,2
"2011","N00000460 (Rich Hill ward)","N00000460",138,89,38,51,1,16,12,4,30,29,1,2
"2011","N00000461 (Rich Hill ward)","N00000461",157,140,70,70,1,3,3,0,13,11,2,0
"2011","N00000462 (Rich Hill ward)","N00000462",101,54,27,27,0,30,28,2,14,13,1,3
"2011","N00000463 (Tandragee ward)","N00000463",343,191,94,97,4,49,43,6,92,88,4,7
"2011","N00000464 (Tandragee ward)","N00000464",156,133,49,84,1,11,11,0,8,6,2,3
"2011","N00000465 (Tandragee ward)","N00000465",129,83,36,47,1,31,31,0,13,11,2,1
"2011","N00000466 (Tandragee ward)","N00000466",138,117,79,38,0,0,0,0,16,13,3,5
"2011","N00000467 (Tandragee ward)","N00000467",131,87,42,45,0,29,29,0,8,8,0,7
"2011","N00000468 (Tandragee ward)","N00000468",116,96,59,37,0,8,8,0,6,6,0,6
"2011","N00000469 (Tandragee ward)","N00000469",154,125,50,75,1,10,10,0,18,17,1,0
"2011","N00000470 (The Mall ward)","N00000470",122,67,38,29,0,30,29,1,23,20,3,2
"2011","N00000471 (The Mall ward)","N00000471",126,77,35,42,0,21,20,1,24,17,7,4
"2011","N00000472 (The Mall ward)","N00000472",133,48,33,15,0,37,37,0,41,38,3,7
"2011","N00000473 (The Mall ward)","N00000473",108,57,39,18,0,32,31,1,16,13,3,3
"2011","N00000474 (The Mall ward)","N00000474",118,80,65,15,0,15,12,3,14,12,2,9
"2011","N00000475 (The Mall ward)","N00000475",116,30,10,20,0,69,36,33,13,11,2,4
"2011","N00000476 (The Mall ward)","N00000476",119,73,43,30,0,32,31,1,10,9,1,4
"2011","N00000715 (Ballydown ward)","N00000715",254,202,62,140,0,1,0,1,49,48,1,2
"2011","N00000716 (Ballydown ward)","N00000716",328,294,146,148,0,1,0,1,29,25,4,4
"2011","N00000717 (Ballydown ward)","N00000717",199,172,78,94,4,0,0,0,18,17,1,5
"2011","N00000718 (Ballydown ward)","N00000718",719,521,204,317,2,10,2,8,170,158,12,16
"2011","N00000719 (Ballydown ward)","N00000719",86,78,34,44,0,1,1,0,7,6,1,0
"2011","N00000720 (Ballydown ward)","N00000720",154,141,43,98,0,0,0,0,11,11,0,2
"2011","N00000722 (Ballyward ward)","N00000722",162,129,66,63,0,14,14,0,13,12,1,6
"2011","N00000727 (Banbridge West ward)","N00000727",124,58,21,37,1,48,35,13,11,8,3,6
"2011","N00000728 (Banbridge West ward)","N00000728",187,119,31,88,2,4,3,1,60,57,3,2
"2011","N00000729 (Banbridge West ward)","N00000729",121,100,44,56,0,3,1,2,16,16,0,2
"2011","N00000730 (Banbridge West ward)","N00000730",121,104,48,56,0,2,2,0,15,13,2,0
"2011","N00000731 (Banbridge West ward)","N00000731",123,77,43,34,0,24,20,4,14,10,4,8
"2011","N00000732 (Banbridge West ward)","N00000732",239,131,24,107,2,4,3,1,100,98,2,2
"2011","N00000733 (Banbridge West ward)","N00000733",112,98,46,52,0,1,1,0,13,11,2,0
"2011","N00000734 (Banbridge West ward)","N00000734",142,78,17,61,1,32,15,17,28,27,1,3
"2011","N00000735 (Bannside ward)","N00000735",143,129,77,52,1,4,4,0,7,7,0,2
"2011","N00000736 (Bannside ward)","N00000736",137,90,47,43,0,30,19,11,10,8,2,7
"2011","N00000737 (Bannside ward)","N00000737",124,112,68,44,0,0,0,0,7,6,1,5
"2011","N00000738 (Bannside ward)","N00000738",138,125,64,61,0,1,1,0,9,6,3,3
"2011","N00000739 (Bannside ward)","N00000739",143,131,78,53,0,1,1,0,6,4,2,5
"2011","N00000740 (Bannside ward)","N00000740",177,167,86,81,0,0,0,0,6,6,0,4
"2011","N00000741 (Dromore North ward)","N00000741",140,128,66,62,0,2,2,0,8,8,0,2
"2011","N00000742 (Dromore North ward)","N00000742",120,95,43,52,0,6,6,0,16,15,1,3
"2011","N00000743 (Dromore North ward)","N00000743",116,48,23,25,0,47,45,2,14,12,2,7
"2011","N00000744 (Dromore North ward)","N00000744",123,85,38,47,2,12,12,0,19,17,2,5
"2011","N00000745 (Dromore North ward)","N00000745",184,147,46,101,3,8,5,3,24,22,2,2
"2011","N00000746 (Dromore North ward)","N00000746",263,98,51,47,1,100,75,25,42,41,1,22
"2011","N00000747 (Dromore North ward)","N00000747",173,109,36,73,2,17,17,0,38,34,4,7
"2011","N00000748 (Dromore South ward)","N00000748",173,142,56,86,2,3,3,0,21,17,4,5
"2011","N00000749 (Dromore South ward)","N00000749",140,107,45,62,0,14,14,0,15,14,1,4
"2011","N00000750 (Dromore South ward)","N00000750",146,93,43,50,4,11,11,0,36,35,1,2
"2011","N00000751 (Dromore South ward)","N00000751",198,134,41,93,4,10,8,2,44,38,6,6
"2011","N00000752 (Dromore South ward)","N00000752",163,127,43,84,2,17,17,0,13,11,2,4
"2011","N00000753 (Dromore South ward)","N00000753",138,130,63,67,0,1,1,0,5,5,0,2
"2011","N00000754 (Dromore South ward)","N00000754",162,129,40,89,0,7,1,6,24,22,2,2
"2011","N00000755 (Dromore South ward)","N00000755",125,113,35,78,0,1,1,0,11,11,0,0
"2011","N00000756 (Dromore South ward)","N00000756",153,94,42,52,1,27,27,0,26,26,0,5
"2011","N00000757 (Dromore South ward)","N00000757",142,134,25,109,0,0,0,0,7,7,0,1
"2011","N00000758 (Edenderry ward)","N00000758",185,78,27,51,1,73,40,33,24,22,2,9
"2011","N00000759 (Edenderry ward)","N00000759",102,91,17,74,1,3,3,0,6,3,3,1
"2011","N00000760 (Edenderry ward)","N00000760",132,71,44,27,0,35,35,0,21,17,4,5
"2011","N00000761 (Edenderry ward)","N00000761",178,76,25,51,2,41,41,0,54,49,5,5
"2011","N00000762 (Edenderry ward)","N00000762",133,42,25,17,0,58,57,1,25,25,0,8
"2011","N00000763 (Edenderry ward)","N00000763",166,94,30,64,0,42,35,7,26,25,1,4
"2011","N00000764 (Edenderry ward)","N00000764",93,81,20,61,1,2,2,0,8,8,0,1
"2011","N00000765 (Edenderry ward)","N00000765",165,70,23,47,2,56,55,1,30,27,3,7
"2011","N00000766 (Fort ward)","N00000766",387,224,120,104,1,91,57,34,46,38,8,25
"2011","N00000767 (Fort ward)","N00000767",108,87,41,46,0,16,16,0,4,4,0,1
"2011","N00000768 (Fort ward)","N00000768",120,62,35,27,2,31,26,5,18,17,1,7
"2011","N00000769 (Fort ward)","N00000769",137,125,45,80,0,1,0,1,9,9,0,2
"2011","N00000770 (Fort ward)","N00000770",117,109,48,61,0,2,2,0,4,4,0,2
"2011","N00000771 (Fort ward)","N00000771",124,57,30,27,0,46,46,0,16,12,4,5
"2011","N00000772 (Gilford ward)","N00000772",157,141,69,72,1,2,2,0,11,10,1,2
"2011","N00000773 (Gilford ward)","N00000773",154,105,28,77,1,20,20,0,24,19,5,4
"2011","N00000774 (Gilford ward)","N00000774",430,277,114,163,4,69,60,9,64,56,8,16
"2011","N00000775 (Gilford ward)","N00000775",123,81,31,50,0,8,8,0,29,26,3,5
"2011","N00000776 (Gilford ward)","N00000776",136,67,32,35,0,44,44,0,21,19,2,4
"2011","N00000777 (Gransha ward)","N00000777",323,271,132,139,2,18,18,0,22,21,1,10
"2011","N00000778 (Gransha ward)","N00000778",142,130,82,48,0,1,1,0,9,6,3,2
"2011","N00000779 (Gransha ward)","N00000779",204,149,80,69,4,18,10,8,26,23,3,7
"2011","N00000780 (Gransha ward)","N00000780",181,165,64,101,0,2,2,0,12,10,2,2
"2011","N00000781 (Gransha ward)","N00000781",204,164,25,139,4,7,1,6,25,24,1,4
"2011","N00000782 (Gransha ward)","N00000782",162,151,80,71,0,2,1,1,4,3,1,5
"2011","N00000783 (Katesbridge ward)","N00000783",195,163,78,85,0,14,14,0,11,10,1,7
"2011","N00000784 (Katesbridge ward)","N00000784",145,126,66,60,0,2,1,1,11,9,2,6
"2011","N00000785 (Katesbridge ward)","N00000785",118,98,58,40,0,9,8,1,9,6,3,2
"2011","N00000786 (Katesbridge ward)","N00000786",129,117,69,48,0,4,4,0,6,5,1,2
"2011","N00000787 (Katesbridge ward)","N00000787",144,128,68,60,0,0,0,0,12,8,4,4
"2011","N00000788 (Katesbridge ward)","N00000788",142,128,69,59,0,1,1,0,10,9,1,3
"2011","N00000789 (Lawrencetown ward)","N00000789",403,272,86,186,3,56,56,0,60,49,11,12
"2011","N00000790 (Lawrencetown ward)","N00000790",193,155,78,77,0,2,1,1,31,28,3,5
"2011","N00000791 (Lawrencetown ward)","N00000791",146,117,77,40,0,11,10,1,12,9,3,6
"2011","N00000792 (Lawrencetown ward)","N00000792",130,119,56,63,0,3,3,0,5,4,1,3
"2011","N00000793 (Lawrencetown ward)","N00000793",146,138,86,52,0,1,1,0,4,4,0,3
"2011","N00000794 (Loughbrickland ward)","N00000794",154,141,76,65,0,6,6,0,6,6,0,1
"2011","N00000795 (Loughbrickland ward)","N00000795",170,152,74,78,0,3,3,0,9,8,1,6
"2011","N00000796 (Loughbrickland ward)","N00000796",141,95,39,56,0,12,12,0,25,23,2,9
"2011","N00000797 (Loughbrickland ward)","N00000797",144,109,49,60,1,10,9,1,16,12,4,8
"2011","N00000798 (Loughbrickland ward)","N00000798",175,153,100,53,0,2,2,0,12,9,3,8
"2011","N00000799 (Loughbrickland ward)","N00000799",193,141,57,84,2,16,15,1,28,26,2,6
"2011","N00000800 (Quilly ward)","N00000800",145,136,73,63,0,0,0,0,7,4,3,2
"2011","N00000801 (Quilly ward)","N00000801",176,156,81,75,0,3,3,0,11,11,0,6
"2011","N00000802 (Quilly ward)","N00000802",114,92,51,41,1,2,2,0,13,11,2,6
"2011","N00000803 (Quilly ward)","N00000803",140,124,65,59,0,3,3,0,11,10,1,2
"2011","N00000804 (Quilly ward)","N00000804",153,142,95,47,0,1,1,0,8,7,1,2
"2011","N00000805 (Quilly ward)","N00000805",134,119,70,49,0,2,2,0,5,4,1,8
"2011","N00000806 (Rathfriland ward)","N00000806",143,86,47,39,0,38,37,1,13,11,2,6
"2011","N00000807 (Rathfriland ward)","N00000807",187,137,56,81,1,1,1,0,43,40,3,5
"2011","N00000808 (Rathfriland ward)","N00000808",119,54,42,12,0,37,16,21,21,17,4,7
"2011","N00000809 (Rathfriland ward)","N00000809",204,114,62,52,3,25,25,0,53,49,4,9
"2011","N00000810 (Rathfriland ward)","N00000810",151,121,68,53,0,9,9,0,16,12,4,5
"2011","N00000811 (Rathfriland ward)","N00000811",148,67,36,31,0,42,42,0,28,27,1,11
"2011","N00000812 (Rathfriland ward)","N00000812",121,65,37,28,0,33,33,0,18,16,2,5
"2011","N00000813 (Seapatrick ward)","N00000813",191,136,58,78,2,13,12,1,36,34,2,4
"2011","N00000814 (Seapatrick ward)","N00000814",118,84,54,30,0,26,26,0,6,6,0,2
"2011","N00000815 (Seapatrick ward)","N00000815",159,143,63,80,0,0,0,0,9,9,0,7
"2011","N00000816 (Seapatrick ward)","N00000816",232,149,63,86,1,51,20,31,21,17,4,10
"2011","N00000817 (Seapatrick ward)","N00000817",104,99,54,45,0,0,0,0,3,3,0,2
"2011","N00000818 (Seapatrick ward)","N00000818",123,96,51,45,1,17,17,0,7,7,0,2
"2011","N00000819 (The Cut ward)","N00000819",132,46,21,25,2,43,41,2,34,31,3,7
"2011","N00000820 (The Cut ward)","N00000820",179,79,38,41,0,32,31,1,64,57,7,4
"2011","N00000821 (The Cut ward)","N00000821",129,62,29,33,0,37,37,0,19,18,1,11
"2011","N00000822 (The Cut ward)","N00000822",127,50,24,26,0,42,42,0,23,23,0,12
"2011","N00000823 (The Cut ward)","N00000823",146,112,65,47,0,14,14,0,16,13,3,4
"2011","N00000824 (The Cut ward)","N00000824",144,57,31,26,1,20,4,16,64,63,1,2
"2011","N00002170 (Aghagallon ward)","N00002170",128,84,42,42,1,24,22,2,15,14,1,4
"2011","N00002171 (Aghagallon ward)","N00002171",161,138,66,72,1,6,4,2,14,11,3,2
"2011","N00002172 (Aghagallon ward)","N00002172",192,152,51,101,1,6,3,3,30,27,3,3
"2011","N00002173 (Aghagallon ward)","N00002173",148,139,78,61,0,0,0,0,4,4,0,5
"2011","N00002174 (Aghagallon ward)","N00002174",173,149,73,76,0,6,6,0,16,12,4,2
"2011","N00002175 (Aghagallon ward)","N00002175",249,213,78,135,4,3,2,1,26,20,6,3
"2011","N00002176 (Aghagallon ward)","N00002176",178,145,40,105,2,0,0,0,31,30,1,0
"2011","N00002177 (Aghagallon ward)","N00002177",183,170,77,93,0,0,0,0,10,9,1,3
"2011","N00002178 (Aghagallon ward)","N00002178",167,138,55,83,2,11,8,3,14,12,2,2
"2011","N00002179 (Annagh ward)","N00002179",139,101,46,55,0,5,1,4,30,27,3,3
"2011","N00002180 (Annagh ward)","N00002180",105,55,28,27,3,15,3,12,31,30,1,1
"2011","N00002181 (Annagh ward)","N00002181",243,192,49,143,0,2,1,1,45,42,3,4
"2011","N00002182 (Annagh ward)","N00002182",136,124,90,34,0,0,0,0,9,8,1,3
"2011","N00002183 (Annagh ward)","N00002183",162,25,17,8,1,36,14,22,94,91,3,6
"2011","N00002184 (Annagh ward)","N00002184",130,32,21,11,0,44,3,41,47,46,1,7
"2011","N00002185 (Annagh ward)","N00002185",217,51,29,22,2,50,4,46,113,110,3,1
"2011","N00002186 (Annagh ward)","N00002186",116,39,27,12,0,21,4,17,55,53,2,1
"2011","N00002187 (Annagh ward)","N00002187",119,59,38,21,1,7,2,5,52,52,0,0
"2011","N00002188 (Ballybay ward)","N00002188",108,29,18,11,2,50,26,24,21,18,3,6
"2011","N00002189 (Ballybay ward)","N00002189",108,55,28,27,0,30,30,0,17,15,2,6
"2011","N00002190 (Ballybay ward)","N00002190",217,69,20,49,4,56,39,17,80,80,0,8
"2011","N00002191 (Ballybay ward)","N00002191",101,31,20,11,0,48,48,0,17,17,0,5
"2011","N00002192 (Ballybay ward)","N00002192",196,148,72,76,3,4,4,0,37,35,2,4
"2011","N00002193 (Ballybay ward)","N00002193",115,51,27,24,0,40,40,0,22,22,0,2
"2011","N00002194 (Ballybay ward)","N00002194",120,54,33,21,1,45,45,0,14,13,1,6
"2011","N00002195 (Ballybay ward)","N00002195",127,73,39,34,0,27,26,1,22,19,3,5
"2011","N00002196 (Ballyoran ward)","N00002196",204,156,68,88,2,2,2,0,38,37,1,6
"2011","N00002197 (Ballyoran ward)","N00002197",212,152,49,103,5,6,6,0,49,49,0,0
"2011","N00002198 (Ballyoran ward)","N00002198",118,59,36,23,0,19,19,0,32,28,4,8
"2011","N00002199 (Ballyoran ward)","N00002199",122,73,31,42,1,16,16,0,29,28,1,3
"2011","N00002200 (Ballyoran ward)","N00002200",161,95,41,54,0,24,24,0,38,35,3,4
"2011","N00002201 (Ballyoran ward)","N00002201",120,56,37,19,3,33,33,0,19,18,1,9
"2011","N00002202 (Ballyoran ward)","N00002202",153,103,65,38,1,3,3,0,43,41,2,3
"2011","N00002203 (Bleary ward)","N00002203",421,369,177,192,4,2,2,0,38,35,3,8
"2011","N00002204 (Bleary ward)","N00002204",156,134,83,51,0,2,2,0,17,15,2,3
"2011","N00002205 (Bleary ward)","N00002205",249,221,69,152,0,1,1,0,25,24,1,2
"2011","N00002206 (Bleary ward)","N00002206",129,110,47,63,0,1,0,1,17,15,2,1
"2011","N00002207 (Bleary ward)","N00002207",118,96,44,52,4,7,7,0,8,6,2,3
"2011","N00002208 (Bleary ward)","N00002208",123,95,49,46,0,13,13,0,10,9,1,5
"2011","N00002209 (Bleary ward)","N00002209",122,106,32,74,2,1,1,0,12,10,2,1
"2011","N00002210 (Bleary ward)","N00002210",136,118,55,63,0,2,2,0,13,11,2,3
"2011","N00002211 (Brownstown ward)","N00002211",131,70,38,32,2,43,24,19,13,12,1,3
"2011","N00002212 (Brownstown ward)","N00002212",107,78,44,34,2,2,2,0,25,24,1,0
"2011","N00002213 (Brownstown ward)","N00002213",278,162,77,85,9,21,6,15,83,81,2,3
"2011","N00002214 (Brownstown ward)","N00002214",138,121,66,55,0,0,0,0,14,12,2,3
"2011","N00002215 (Brownstown ward)","N00002215",120,75,43,32,0,21,21,0,20,18,2,4
"2011","N00002216 (Brownstown ward)","N00002216",124,63,35,28,0,31,31,0,22,18,4,8
"2011","N00002217 (Brownstown ward)","N00002217",111,58,34,24,1,26,6,20,23,11,12,3
"2011","N00002218 (Brownstown ward)","N00002218",109,74,40,34,3,7,0,7,19,15,4,6
"2011","N00002219 (Brownstown ward)","N00002219",114,64,44,20,0,24,23,1,24,23,1,2
"2011","N00002220 (Brownstown ward)","N00002220",176,118,32,86,4,4,3,1,48,43,5,2
"2011","N00002221 (Church ward)","N00002221",197,113,75,38,0,43,41,2,38,35,3,3
"2011","N00002222 (Church ward)","N00002222",120,37,19,18,1,42,35,7,35,34,1,5
"2011","N00002223 (Church ward)","N00002223",71,29,15,14,0,29,28,1,10,9,1,3
"2011","N00002224 (Church ward)","N00002224",89,32,17,15,1,16,12,4,37,36,1,3
"2011","N00002225 (Church ward)","N00002225",193,83,52,31,0,79,78,1,23,21,2,8
"2011","N00002226 (Church ward)","N00002226",99,31,18,13,0,50,50,0,10,10,0,8
"2011","N00002227 (Church ward)","N00002227",112,64,42,22,0,29,28,1,17,16,1,2
"2011","N00002228 (Church ward)","N00002228",120,78,43,35,0,23,23,0,15,15,0,4
"2011","N00002229 (Corcrain ward)","N00002229",340,179,55,124,1,57,27,30,98,96,2,5
"2011","N00002230 (Corcrain ward)","N00002230",120,27,12,15,0,76,74,2,12,12,0,5
"2011","N00002231 (Corcrain ward)","N00002231",145,28,16,12,1,94,94,0,12,11,1,10
"2011","N00002232 (Corcrain ward)","N00002232",324,113,50,63,4,51,41,10,146,140,6,10
"2011","N00002233 (Corcrain ward)","N00002233",140,35,19,16,3,53,35,18,39,39,0,10
"2011","N00002234 (Corcrain ward)","N00002234",120,39,16,23,0,49,23,26,26,25,1,6
"2011","N00002235 (Corcrain ward)","N00002235",137,41,24,17,0,70,68,2,20,19,1,6
"2011","N00002236 (Court ward)","N00002236",328,105,50,55,3,120,62,58,88,79,9,12
"2011","N00002237 (Court ward)","N00002237",123,82,28,54,0,11,7,4,30,26,4,0
"2011","N00002238 (Court ward)","N00002238",98,42,13,29,0,26,24,2,29,26,3,1
"2011","N00002239 (Court ward)","N00002239",108,61,39,22,0,20,20,0,24,23,1,3
"2011","N00002240 (Court ward)","N00002240",145,66,21,45,0,58,42,16,15,15,0,6
"2011","N00002241 (Court ward)","N00002241",116,29,10,19,2,48,15,33,34,31,3,3
"2011","N00002242 (Court ward)","N00002242",113,72,45,27,3,8,7,1,23,18,5,7
"2011","N00002243 (Court ward)","N00002243",122,42,13,29,1,43,9,34,32,28,4,4
"2011","N00002244 (Court ward)","N00002244",114,81,54,27,0,7,7,0,22,19,3,4
"2011","N00002245 (Court ward)","N00002245",128,16,8,8,0,81,70,11,9,7,2,22
"2011","N00002246 (Derrytrasna ward)","N00002246",150,130,56,74,3,8,8,0,6,5,1,3
"2011","N00002247 (Derrytrasna ward)","N00002247",146,112,46,66,2,0,0,0,29,27,2,3
"2011","N00002248 (Derrytrasna ward)","N00002248",248,210,59,151,0,4,3,1,32,30,2,2
"2011","N00002249 (Derrytrasna ward)","N00002249",179,160,52,108,0,3,3,0,15,12,3,1
"2011","N00002250 (Derrytrasna ward)","N00002250",115,92,38,54,4,1,1,0,17,14,3,1
"2011","N00002251 (Derrytrasna ward)","N00002251",136,110,35,75,6,0,0,0,19,18,1,1
"2011","N00002252 (Derrytrasna ward)","N00002252",264,241,116,125,0,0,0,0,17,13,4,6
"2011","N00002253 (Derrytrasna ward)","N00002253",129,118,61,57,0,0,0,0,9,8,1,2
"2011","N00002254 (Derrytrasna ward)","N00002254",197,124,56,68,0,0,0,0,72,64,8,1
"2011","N00002255 (Derrytrasna ward)","N00002255",177,152,62,90,1,3,3,0,20,16,4,1
"2011","N00002256 (Donaghcloney ward)","N00002256",166,144,80,64,1,5,5,0,15,13,2,1
"2011","N00002257 (Donaghcloney ward)","N00002257",140,96,39,57,0,31,30,1,7,5,2,6
"2011","N00002258 (Donaghcloney ward)","N00002258",126,104,56,48,0,10,2,8,10,10,0,2
"2011","N00002259 (Donaghcloney ward)","N00002259",153,81,26,55,2,42,13,29,23,22,1,5
"2011","N00002260 (Donaghcloney ward)","N00002260",299,242,62,180,6,12,12,0,34,32,2,5
"2011","N00002261 (Donaghcloney ward)","N00002261",225,195,60,135,0,2,2,0,25,24,1,3
"2011","N00002262 (Donaghcloney ward)","N00002262",156,132,71,61,0,9,9,0,11,10,1,4
"2011","N00002263 (Donaghcloney ward)","N00002263",159,145,55,90,1,1,1,0,9,7,2,3
"2011","N00002264 (Drumgask ward)","N00002264",257,171,42,129,2,21,16,5,63,61,2,0
"2011","N00002265 (Drumgask ward)","N00002265",216,125,30,95,2,10,10,0,79,73,6,0
"2011","N00002266 (Drumgask ward)","N00002266",108,43,11,32,1,57,57,0,4,4,0,3
"2011","N00002267 (Drumgask ward)","N00002267",172,70,22,48,1,67,67,0,26,25,1,8
"2011","N00002268 (Drumgask ward)","N00002268",290,173,37,136,2,21,20,1,90,88,2,4
"2011","N00002269 (Drumgask ward)","N00002269",117,50,20,30,0,51,51,0,13,13,0,3
"2011","N00002270 (Drumgask ward)","N00002270",120,48,18,30,1,59,52,7,11,10,1,1
"2011","N00002271 (Drumgask ward)","N00002271",113,34,16,18,0,57,57,0,22,22,0,0
"2011","N00002272 (Drumgask ward)","N00002272",99,26,9,17,0,61,60,1,9,9,0,3
"2011","N00002273 (Drumgor ward)","N00002273",214,142,28,114,2,1,1,0,69,67,2,0
"2011","N00002274 (Drumgor ward)","N00002274",98,16,6,10,0,49,49,0,31,30,1,2
"2011","N00002275 (Drumgor ward)","N00002275",103,42,25,17,3,41,41,0,15,14,1,2
"2011","N00002276 (Drumgor ward)","N00002276",124,92,44,48,5,1,0,1,24,22,2,2
"2011","N00002277 (Drumgor ward)","N00002277",194,94,38,56,3,20,18,2,76,73,3,1
"2011","N00002278 (Drumgor ward)","N00002278",137,65,33,32,1,39,39,0,29,25,4,3
"2011","N00002279 (Drumgor ward)","N00002279",111,50,21,29,1,45,45,0,11,10,1,4
"2011","N00002280 (Drumgor ward)","N00002280",116,64,34,30,0,30,30,0,19,16,3,3
"2011","N00002281 (Drumnamoe ward)","N00002281",127,58,17,41,2,46,45,1,17,17,0,4
"2011","N00002282 (Drumnamoe ward)","N00002282",114,28,7,21,0,60,59,1,11,11,0,15
"2011","N00002283 (Drumnamoe ward)","N00002283",106,58,26,32,1,32,29,3,13,13,0,2
"2011","N00002284 (Drumnamoe ward)","N00002284",128,64,36,28,0,36,35,1,23,22,1,5
"2011","N00002285 (Drumnamoe ward)","N00002285",128,114,49,65,1,0,0,0,11,11,0,2
"2011","N00002286 (Drumnamoe ward)","N00002286",127,113,66,47,1,1,1,0,12,10,2,0
"2011","N00002287 (Drumnamoe ward)","N00002287",122,98,54,44,0,6,6,0,15,14,1,3
"2011","N00002288 (Drumnamoe ward)","N00002288",118,79,43,36,0,21,21,0,16,15,1,2
"2011","N00002289 (Edenderry ward)","N00002289",107,57,33,24,1,28,27,1,19,17,2,2
"2011","N00002290 (Edenderry ward)","N00002290",238,123,82,41,1,63,8,55,49,42,7,2
"2011","N00002291 (Edenderry ward)","N00002291",227,94,48,46,0,48,6,42,82,79,3,3
"2011","N00002292 (Edenderry ward)","N00002292",118,100,60,40,0,4,3,1,8,7,1,6
"2011","N00002293 (Edenderry ward)","N00002293",113,52,38,14,0,48,48,0,9,7,2,4
"2011","N00002294 (Edenderry ward)","N00002294",123,106,69,37,1,0,0,0,16,15,1,0
"2011","N00002295 (Edenderry ward)","N00002295",137,107,50,57,1,5,4,1,21,18,3,3
"2011","N00002296 (Edenderry ward)","N00002296",143,80,27,53,2,23,22,1,38,36,2,0
"2011","N00002297 (Edenderry ward)","N00002297",124,118,67,51,0,0,0,0,4,4,0,2
"2011","N00002298 (Kernan ward)","N00002298",137,91,64,27,2,19,19,0,21,18,3,4
"2011","N00002299 (Kernan ward)","N00002299",149,121,58,63,1,10,10,0,13,13,0,4
"2011","N00002300 (Kernan ward)","N00002300",318,259,94,165,10,2,2,0,45,40,5,2
"2011","N00002301 (Kernan ward)","N00002301",242,190,84,106,1,3,3,0,43,41,2,5
"2011","N00002302 (Kernan ward)","N00002302",221,195,88,107,0,2,1,1,24,23,1,0
"2011","N00002303 (Kernan ward)","N00002303",158,116,38,78,1,2,2,0,37,37,0,2
"2011","N00002304 (Kernan ward)","N00002304",88,27,7,20,1,47,47,0,7,5,2,6
"2011","N00002305 (Kernan ward)","N00002305",311,246,60,186,10,2,2,0,51,50,1,2
"2011","N00002306 (Kernan ward)","N00002306",524,316,56,260,7,48,43,5,149,144,5,4
"2011","N00002307 (Kernan ward)","N00002307",134,117,56,61,0,4,4,0,11,10,1,2
"2011","N00002308 (Killycomain ward)","N00002308",124,113,56,57,0,1,1,0,9,9,0,1
"2011","N00002309 (Killycomain ward)","N00002309",101,52,24,28,1,25,25,0,21,20,1,2
"2011","N00002310 (Killycomain ward)","N00002310",103,47,23,24,0,35,35,0,15,14,1,6
"2011","N00002311 (Killycomain ward)","N00002311",119,76,36,40,1,11,10,1,30,29,1,1
"2011","N00002312 (Killycomain ward)","N00002312",137,69,35,34,0,41,41,0,18,17,1,9
"2011","N00002313 (Killycomain ward)","N00002313",140,112,73,39,1,2,1,1,19,18,1,6
"2011","N00002314 (Killycomain ward)","N00002314",121,99,67,32,0,0,0,0,17,15,2,5
"2011","N00002315 (Killycomain ward)","N00002315",145,102,54,48,0,21,1,20,19,16,3,3
"2011","N00002316 (Killycomain ward)","N00002316",116,86,59,27,2,8,8,0,19,16,3,1
"2011","N00002317 (Knocknashane ward)","N00002317",118,109,62,47,0,0,0,0,7,5,2,2
"2011","N00002318 (Knocknashane ward)","N00002318",169,134,86,48,0,2,2,0,28,25,3,5
"2011","N00002319 (Knocknashane ward)","N00002319",260,219,104,115,1,1,1,0,30,25,5,9
"2011","N00002320 (Knocknashane ward)","N00002320",131,85,51,34,0,6,3,3,37,35,2,3
"2011","N00002321 (Knocknashane ward)","N00002321",117,98,53,45,0,0,0,0,13,9,4,6
"2011","N00002322 (Knocknashane ward)","N00002322",125,110,66,44,0,0,0,0,15,11,4,0
"2011","N00002323 (Knocknashane ward)","N00002323",132,117,67,50,2,1,1,0,9,6,3,3
"2011","N00002324 (Knocknashane ward)","N00002324",106,91,43,48,1,0,0,0,12,11,1,2
"2011","N00002325 (Knocknashane ward)","N00002325",173,153,68,85,1,5,1,4,10,8,2,4
"2011","N00002326 (Magheralin ward)","N00002326",130,91,41,50,1,24,24,0,12,12,0,2
"2011","N00002327 (Magheralin ward)","N00002327",460,405,147,258,1,4,1,3,41,34,7,9
"2011","N00002328 (Magheralin ward)","N00002328",130,120,49,71,0,1,1,0,8,7,1,1
"2011","N00002329 (Magheralin ward)","N00002329",135,82,37,45,0,25,25,0,21,19,2,7
"2011","N00002330 (Magheralin ward)","N00002330",215,188,69,119,0,2,2,0,24,23,1,1
"2011","N00002331 (Magheralin ward)","N00002331",199,147,73,74,0,6,5,1,38,35,3,8
"2011","N00002332 (Magheralin ward)","N00002332",159,112,35,77,4,15,12,3,19,19,0,9
"2011","N00002333 (Magheralin ward)","N00002333",149,128,53,75,1,1,1,0,15,13,2,4
"2011","N00002334 (Magheralin ward)","N00002334",125,92,38,54,1,17,17,0,12,12,0,3
"2011","N00002335 (Magheralin ward)","N00002335",202,168,67,101,2,9,8,1,20,16,4,3
"2011","N00002336 (Mourneview ward)","N00002336",132,109,58,51,1,4,4,0,17,13,4,1
"2011","N00002337 (Mourneview ward)","N00002337",139,74,23,51,0,43,28,15,17,16,1,5
"2011","N00002338 (Mourneview ward)","N00002338",109,63,34,29,0,30,30,0,15,14,1,1
"2011","N00002339 (Mourneview ward)","N00002339",116,93,31,62,0,11,10,1,8,7,1,4
"2011","N00002340 (Mourneview ward)","N00002340",114,78,37,41,1,17,17,0,15,15,0,3
"2011","N00002341 (Mourneview ward)","N00002341",100,56,31,25,1,16,16,0,23,22,1,4
"2011","N00002342 (Mourneview ward)","N00002342",115,58,18,40,0,36,36,0,16,16,0,5
"2011","N00002343 (Mourneview ward)","N00002343",117,81,7,74,2,5,4,1,27,27,0,2
"2011","N00002344 (Parklake ward)","N00002344",182,67,38,29,1,37,29,8,74,68,6,3
"2011","N00002345 (Parklake ward)","N00002345",153,43,29,14,1,55,22,33,44,40,4,10
"2011","N00002346 (Parklake ward)","N00002346",114,68,32,36,0,5,4,1,40,36,4,1
"2011","N00002347 (Parklake ward)","N00002347",280,200,105,95,2,6,5,1,66,59,7,6
"2011","N00002348 (Parklake ward)","N00002348",169,74,32,42,1,62,62,0,24,21,3,8
"2011","N00002349 (Parklake ward)","N00002349",113,84,38,46,0,8,7,1,21,20,1,0
"2011","N00002350 (Parklake ward)","N00002350",96,71,46,25,2,9,9,0,8,5,3,6
"2011","N00002351 (Parklake ward)","N00002351",418,329,67,262,4,3,3,0,81,77,4,1
"2011","N00002352 (Parklake ward)","N00002352",137,68,40,28,0,43,5,38,24,15,9,2
"2011","N00002353 (Taghnevan ward)","N00002353",647,414,119,295,10,39,17,22,181,175,6,3
"2011","N00002354 (Taghnevan ward)","N00002354",151,102,41,61,0,17,16,1,31,30,1,1
"2011","N00002355 (Taghnevan ward)","N00002355",112,62,27,35,0,27,26,1,22,20,2,1
"2011","N00002356 (Taghnevan ward)","N00002356",140,107,34,73,1,2,2,0,28,28,0,2
"2011","N00002357 (Taghnevan ward)","N00002357",146,65,27,38,1,50,47,3,26,24,2,4
"2011","N00002358 (Taghnevan ward)","N00002358",110,51,26,25,1,18,18,0,35,34,1,5
"2011","N00002359 (Taghnevan ward)","N00002359",118,62,33,29,0,29,29,0,24,21,3,3
"2011","N00002360 (Tavanagh ward)","N00002360",115,82,52,30,2,16,15,1,13,13,0,2
"2011","N00002361 (Tavanagh ward)","N00002361",116,44,19,25,0,47,46,1,23,22,1,2
"2011","N00002362 (Tavanagh ward)","N00002362",113,33,11,22,0,62,62,0,9,9,0,9
"2011","N00002363 (Tavanagh ward)","N00002363",108,44,21,23,0,42,40,2,16,14,2,6
"2011","N00002364 (Tavanagh ward)","N00002364",118,38,20,18,0,60,54,6,19,18,1,1
"2011","N00002365 (Tavanagh ward)","N00002365",121,52,21,31,0,47,47,0,20,20,0,2
"2011","N00002366 (Tavanagh ward)","N00002366",118,66,36,30,0,22,17,5,26,24,2,4
"2011","N00002367 (Tavanagh ward)","N00002367",164,121,68,53,2,0,0,0,37,35,2,4
"2011","N00002368 (The Birches ward)","N00002368",141,128,53,75,0,2,2,0,8,6,2,3
"2011","N00002369 (The Birches ward)","N00002369",289,192,74,118,1,3,3,0,88,75,13,5
"2011","N00002370 (The Birches ward)","N00002370",128,107,59,48,1,1,1,0,16,12,4,3
"2011","N00002371 (The Birches ward)","N00002371",146,126,62,64,0,2,2,0,8,8,0,10
"2011","N00002372 (The Birches ward)","N00002372",211,167,87,80,0,6,6,0,36,30,6,2
"2011","N00002373 (The Birches ward)","N00002373",139,104,58,46,0,8,7,1,23,21,2,4
"2011","N00002374 (The Birches ward)","N00002374",126,78,49,29,0,22,17,5,15,12,3,11
"2011","N00002375 (The Birches ward)","N00002375",132,112,77,35,0,0,0,0,17,14,3,3
"2011","N00002376 (Waringstown ward)","N00002376",148,133,76,57,2,1,1,0,8,8,0,4
"2011","N00002377 (Waringstown ward)","N00002377",169,118,46,72,5,25,25,0,20,19,1,1
"2011","N00002378 (Waringstown ward)","N00002378",306,226,65,161,2,27,26,1,48,45,3,3
"2011","N00002379 (Waringstown ward)","N00002379",251,199,93,106,4,5,5,0,41,40,1,2
"2011","N00002380 (Waringstown ward)","N00002380",133,110,70,40,1,9,8,1,8,7,1,5
"2011","N00002381 (Waringstown ward)","N00002381",149,130,65,65,2,0,0,0,15,12,3,2
"2011","N00002382 (Waringstown ward)","N00002382",181,149,66,83,0,1,1,0,28,26,2,3
"2011","N00002383 (Waringstown ward)","N00002383",150,141,67,74,0,2,2,0,7,7,0,0
"2011","N00002384 (Waringstown ward)","N00002384",144,123,50,73,1,1,1,0,13,10,3,6
"2011","N00002385 (Waringstown ward)","N00002385",108,93,40,53,1,1,0,1,13,11,2,0
"2011","N00002386 (Woodville ward)","N00002386",127,71,29,42,4,7,2,5,43,39,4,2
"2011","N00002387 (Woodville ward)","N00002387",266,105,56,49,2,74,25,49,82,74,8,3
"2011","N00002388 (Woodville ward)","N00002388",92,45,19,26,2,8,2,6,35,35,0,2
"2011","N00002389 (Woodville ward)","N00002389",134,82,46,36,1,1,0,1,47,41,6,3
"2011","N00002390 (Woodville ward)","N00002390",142,68,31,37,0,14,2,12,58,56,2,2
"2011","N00002391 (Woodville ward)","N00002391",136,120,77,43,2,0,0,0,12,10,2,2
"2011","N00002392 (Woodville ward)","N00002392",116,99,46,53,0,2,2,0,11,9,2,4
"2011","N00002393 (Woodville ward)","N00002393",197,184,55,129,0,1,1,0,11,11,0,1
"2011","N00002394 (Woodville ward)","N00002394",154,91,37,54,1,5,2,3,57,51,6,0
"2011","N00002395 (Woodville ward)","N00002395",126,105,20,85,2,0,0,0,17,15,2,2
"2011","N00002880 (Killyman ward)","N00002880",151,136,87,49,0,0,0,0,9,9,0,6
"2011","N00002882 (Killyman ward)","N00002882",134,103,58,45,1,15,15,0,10,8,2,5
"2011","N00002892 (Moy ward)","N00002892",154,117,60,57,1,3,3,0,29,23,6,4
"2011","N00000825 (Andersonstown ward)","N00000825",136,123,66,57,0,1,0,1,8,7,1,4
"2011","N00000826 (Andersonstown ward)","N00000826",115,89,33,56,0,22,18,4,4,4,0,0
"2011","N00000827 (Andersonstown ward)","N00000827",121,107,73,34,0,2,0,2,10,7,3,2
"2011","N00000828 (Andersonstown ward)","N00000828",104,60,27,33,1,15,3,12,28,27,1,0
"2011","N00000829 (Andersonstown ward)","N00000829",131,88,47,41,2,14,4,10,25,24,1,2
"2011","N00000830 (Andersonstown ward)","N00000830",132,19,5,14,0,104,17,87,1,1,0,8
"2011","N00000831 (Andersonstown ward)","N00000831",134,60,25,35,0,34,3,31,40,39,1,0
"2011","N00000832 (Andersonstown ward)","N00000832",122,71,30,41,0,30,19,11,11,11,0,10
"2011","N00000833 (Andersonstown ward)","N00000833",120,76,35,41,2,32,28,4,5,4,1,5
"2011","N00000834 (Andersonstown ward)","N00000834",136,97,57,40,1,8,2,6,27,21,6,3
"2011","N00000835 (Andersonstown ward)","N00000835",112,58,29,29,0,13,1,12,40,38,2,1
"2011","N00000836 (Andersonstown ward)","N00000836",126,91,38,53,1,22,18,4,10,7,3,2
"2011","N00000837 (Andersonstown ward)","N00000837",122,98,35,63,0,11,11,0,11,11,0,2
"2011","N00000838 (Andersonstown ward)","N00000838",119,88,33,55,0,18,16,2,13,11,2,0
"2011","N00000839 (Andersonstown ward)","N00000839",156,124,63,61,0,2,1,1,23,19,4,7
"2011","N00000840 (Andersonstown ward)","N00000840",118,105,71,34,0,1,1,0,10,10,0,2
"2011","N00000841 (Ardoyne ward)","N00000841",123,27,8,19,0,71,61,10,18,18,0,7
"2011","N00000842 (Ardoyne ward)","N00000842",209,73,24,49,2,106,77,29,21,21,0,7
"2011","N00000843 (Ardoyne ward)","N00000843",107,67,35,32,0,17,7,10,22,19,3,1
"2011","N00000844 (Ardoyne ward)","N00000844",98,53,22,31,2,7,4,3,31,30,1,5
"2011","N00000845 (Ardoyne ward)","N00000845",98,68,36,32,0,4,3,1,24,24,0,2
"2011","N00000846 (Ardoyne ward)","N00000846",114,69,38,31,1,18,14,4,25,22,3,1
"2011","N00000847 (Ardoyne ward)","N00000847",367,123,66,57,1,162,61,101,64,59,5,17
"2011","N00000848 (Ardoyne ward)","N00000848",112,61,34,27,1,34,29,5,12,12,0,4
"2011","N00000849 (Ardoyne ward)","N00000849",144,76,41,35,1,37,34,3,28,27,1,2
"2011","N00000850 (Ardoyne ward)","N00000850",121,63,32,31,1,12,11,1,41,40,1,4
"2011","N00000851 (Ardoyne ward)","N00000851",115,46,25,21,0,33,25,8,34,30,4,2
"2011","N00000852 (Ardoyne ward)","N00000852",543,118,30,88,2,355,206,149,32,28,4,36
"2011","N00000853 (Ardoyne ward)","N00000853",108,26,7,19,1,69,65,4,5,4,1,7
"2011","N00000854 (Ardoyne ward)","N00000854",309,69,10,59,1,211,151,60,16,15,1,12
"2011","N00000855 (Ballyhackamore ward)","N00000855",104,68,33,35,2,6,6,0,26,22,4,2
"2011","N00000856 (Ballyhackamore ward)","N00000856",90,72,39,33,0,0,0,0,16,14,2,2
"2011","N00000857 (Ballyhackamore ward)","N00000857",157,120,56,64,0,2,2,0,27,24,3,8
"2011","N00000858 (Ballyhackamore ward)","N00000858",131,61,30,31,2,8,3,5,60,54,6,0
"2011","N00000859 (Ballyhackamore ward)","N00000859",138,95,33,62,3,1,0,1,36,34,2,3
"2011","N00000860 (Ballyhackamore ward)","N00000860",151,129,58,71,0,12,1,11,10,9,1,0
"2011","N00000861 (Ballyhackamore ward)","N00000861",124,110,46,64,0,1,1,0,11,9,2,2
"2011","N00000862 (Ballyhackamore ward)","N00000862",388,283,121,162,0,32,13,19,69,62,7,4
"2011","N00000863 (Ballyhackamore ward)","N00000863",128,120,63,57,0,2,1,1,4,3,1,2
"2011","N00000864 (Ballyhackamore ward)","N00000864",125,105,51,54,0,7,2,5,12,9,3,1
"2011","N00000865 (Ballyhackamore ward)","N00000865",126,108,44,64,0,0,0,0,18,17,1,0
"2011","N00000866 (Ballyhackamore ward)","N00000866",164,67,16,51,2,29,4,25,62,59,3,4
"2011","N00000867 (Ballyhackamore ward)","N00000867",159,84,35,49,0,13,5,8,60,58,2,2
"2011","N00000868 (Ballyhackamore ward)","N00000868",130,111,38,73,0,0,0,0,19,18,1,0
"2011","N00000869 (Ballyhackamore ward)","N00000869",106,35,14,21,0,50,22,28,15,15,0,6
"2011","N00000870 (Ballyhackamore ward)","N00000870",157,118,44,74,0,3,2,1,32,29,3,4
"2011","N00000871 (Ballyhackamore ward)","N00000871",155,94,56,38,1,35,7,28,23,21,2,2
"2011","N00000872 (Ballyhackamore ward)","N00000872",134,81,42,39,0,28,25,3,18,17,1,7
"2011","N00000873 (Ballymacarrett ward)","N00000873",132,67,18,49,0,53,52,1,8,7,1,4
"2011","N00000874 (Ballymacarrett ward)","N00000874",268,79,29,50,0,106,77,29,71,66,5,12
"2011","N00000875 (Ballymacarrett ward)","N00000875",124,50,23,27,0,63,59,4,8,5,3,3
"2011","N00000876 (Ballymacarrett ward)","N00000876",119,24,12,12,1,79,33,46,8,5,3,7
"2011","N00000877 (Ballymacarrett ward)","N00000877",158,35,8,27,0,107,82,25,7,5,2,9
"2011","N00000878 (Ballymacarrett ward)","N00000878",119,19,6,13,0,88,63,25,4,2,2,8
"2011","N00000879 (Ballymacarrett ward)","N00000879",398,157,69,88,3,199,89,110,32,29,3,7
"2011","N00000880 (Ballymacarrett ward)","N00000880",123,48,22,26,0,63,55,8,9,8,1,3
"2011","N00000881 (Ballymacarrett ward)","N00000881",148,38,12,26,1,79,79,0,22,16,6,8
"2011","N00000882 (Ballymacarrett ward)","N00000882",139,27,13,14,0,81,80,1,23,23,0,8
"2011","N00000883 (Ballymacarrett ward)","N00000883",133,42,16,26,2,71,71,0,7,6,1,11
"2011","N00000884 (Ballymacarrett ward)","N00000884",113,41,11,30,3,53,51,2,8,8,0,8
"2011","N00000885 (Ballymacarrett ward)","N00000885",323,78,29,49,1,116,106,10,118,118,0,10
"2011","N00000886 (Ballynafeigh ward)","N00000886",128,39,15,24,0,14,12,2,74,64,10,1
"2011","N00000887 (Ballynafeigh ward)","N00000887",133,82,31,51,0,20,10,10,29,28,1,2
"2011","N00000888 (Ballynafeigh ward)","N00000888",143,65,28,37,3,20,15,5,53,50,3,2
"2011","N00000889 (Ballynafeigh ward)","N00000889",110,85,29,56,0,4,4,0,21,21,0,0
"2011","N00000890 (Ballynafeigh ward)","N00000890",150,83,29,54,1,22,17,5,40,39,1,4
"2011","N00000891 (Ballynafeigh ward)","N00000891",181,54,24,30,2,49,10,39,75,71,4,1
"2011","N00000892 (Ballynafeigh ward)","N00000892",137,89,32,57,1,7,7,0,39,35,4,1
"2011","N00000893 (Ballynafeigh ward)","N00000893",135,66,24,42,6,0,0,0,62,58,4,1
"2011","N00000894 (Ballynafeigh ward)","N00000894",141,90,30,60,0,10,2,8,39,36,3,2
"2011","N00000895 (Ballynafeigh ward)","N00000895",121,57,17,40,1,22,22,0,38,35,3,3
"2011","N00000896 (Ballynafeigh ward)","N00000896",139,70,26,44,4,10,7,3,53,49,4,2
"2011","N00000897 (Ballynafeigh ward)","N00000897",137,67,18,49,1,12,5,7,56,55,1,1
"2011","N00000898 (Ballynafeigh ward)","N00000898",138,60,26,34,1,23,8,15,54,50,4,0
"2011","N00000899 (Ballynafeigh ward)","N00000899",158,43,21,22,2,65,6,59,42,38,4,6
"2011","N00000900 (Ballynafeigh ward)","N00000900",109,28,12,16,1,69,32,37,9,8,1,2
"2011","N00000901 (Ballynafeigh ward)","N00000901",140,64,29,35,1,13,1,12,61,56,5,1
"2011","N00000902 (Ballynafeigh ward)","N00000902",143,66,24,42,1,7,3,4,64,61,3,5
"2011","N00000903 (Ballynafeigh ward)","N00000903",94,9,4,5,1,75,71,4,6,3,3,3
"2011","N00000904 (Ballynafeigh ward)","N00000904",219,49,17,32,1,59,10,49,108,102,6,2
"2011","N00000905 (Ballynafeigh ward)","N00000905",144,34,18,16,0,65,8,57,41,38,3,4
"2011","N00000906 (Ballysillan ward)","N00000906",105,95,55,40,0,1,1,0,7,7,0,2
"2011","N00000907 (Ballysillan ward)","N00000907",129,47,10,37,1,70,69,1,7,6,1,4
"2011","N00000908 (Ballysillan ward)","N00000908",146,77,35,42,0,45,42,3,21,20,1,3
"2011","N00000909 (Ballysillan ward)","N00000909",81,57,32,25,0,15,15,0,7,5,2,2
"2011","N00000910 (Ballysillan ward)","N00000910",129,63,31,32,0,21,17,4,43,42,1,2
"2011","N00000911 (Ballysillan ward)","N00000911",109,32,15,17,0,63,62,1,11,10,1,3
"2011","N00000912 (Ballysillan ward)","N00000912",95,36,17,19,0,47,45,2,8,8,0,4
"2011","N00000913 (Ballysillan ward)","N00000913",127,43,22,21,1,71,69,2,9,9,0,3
"2011","N00000914 (Ballysillan ward)","N00000914",123,91,48,43,0,13,12,1,14,12,2,5
"2011","N00000915 (Ballysillan ward)","N00000915",116,72,35,37,0,1,1,0,42,38,4,1
"2011","N00000916 (Ballysillan ward)","N00000916",122,90,40,50,0,5,5,0,26,24,2,1
"2011","N00000917 (Ballysillan ward)","N00000917",116,90,39,51,1,3,1,2,20,20,0,2
"2011","N00000918 (Ballysillan ward)","N00000918",121,97,40,57,0,6,6,0,17,17,0,1
"2011","N00000919 (Ballysillan ward)","N00000919",108,80,33,47,1,1,1,0,26,25,1,0
"2011","N00000920 (Ballysillan ward)","N00000920",79,35,19,16,0,37,36,1,6,6,0,1
"2011","N00000921 (Ballysillan ward)","N00000921",209,184,21,163,5,9,4,5,10,9,1,1
"2011","N00000922 (Ballysillan ward)","N00000922",127,100,53,47,0,15,13,2,10,10,0,2
"2011","N00000923 (Ballysillan ward)","N00000923",114,84,32,52,0,3,2,1,23,22,1,4
"2011","N00000924 (Ballysillan ward)","N00000924",106,80,39,41,0,8,8,0,15,15,0,3
"2011","N00000925 (Ballysillan ward)","N00000925",119,64,32,32,0,42,42,0,10,8,2,3
"2011","N00000926 (Beechmount ward)","N00000926",121,81,47,34,4,4,3,1,30,30,0,2
"2011","N00000927 (Beechmount ward)","N00000927",202,74,31,43,1,11,6,5,114,39,75,2
"2011","N00000928 (Beechmount ward)","N00000928",149,116,62,54,1,8,4,4,23,18,5,1
"2011","N00000929 (Beechmount ward)","N00000929",155,84,36,48,0,51,36,15,20,18,2,0
"2011","N00000930 (Beechmount ward)","N00000930",169,104,54,50,0,17,17,0,44,42,2,4
"2011","N00000931 (Beechmount ward)","N00000931",246,26,4,22,0,185,44,141,27,25,2,8
"2011","N00000932 (Beechmount ward)","N00000932",174,64,39,25,1,46,7,39,59,53,6,4
"2011","N00000933 (Beechmount ward)","N00000933",134,74,35,39,1,6,4,2,49,44,5,4
"2011","N00000934 (Beechmount ward)","N00000934",119,79,34,45,1,11,9,2,25,24,1,3
"2011","N00000935 (Beechmount ward)","N00000935",115,56,30,26,0,14,6,8,39,36,3,6
"2011","N00000936 (Beechmount ward)","N00000936",183,67,13,54,0,103,89,14,5,4,1,8
"2011","N00000937 (Beechmount ward)","N00000937",174,132,66,66,1,17,14,3,23,21,2,1
"2011","N00000938 (Beechmount ward)","N00000938",116,63,10,53,9,27,9,18,15,12,3,2
"2011","N00000939 (Beechmount ward)","N00000939",90,49,27,22,0,12,8,4,29,27,2,0
"2011","N00000940 (Beechmount ward)","N00000940",122,67,26,41,0,13,13,0,40,38,2,2
"2011","N00000941 (Bellevue ward)","N00000941",131,113,60,53,1,5,5,0,11,6,5,1
"2011","N00000942 (Bellevue ward)","N00000942",122,109,51,58,0,2,2,0,9,9,0,2
"2011","N00000943 (Bellevue ward)","N00000943",105,85,31,54,0,5,5,0,13,10,3,2
"2011","N00000944 (Bellevue ward)","N00000944",91,39,17,22,0,40,38,2,9,9,0,3
"2011","N00000945 (Bellevue ward)","N00000945",105,95,51,44,1,1,1,0,8,6,2,0
"2011","N00000946 (Bellevue ward)","N00000946",207,83,31,52,2,74,71,3,37,37,0,11
"2011","N00000947 (Bellevue ward)","N00000947",117,69,26,43,2,31,18,13,15,11,4,0
"2011","N00000948 (Bellevue ward)","N00000948",108,74,28,46,3,4,2,2,26,21,5,1
"2011","N00000949 (Bellevue ward)","N00000949",134,72,32,40,1,44,26,18,13,11,2,4
"2011","N00000950 (Bellevue ward)","N00000950",138,59,27,32,1,35,16,19,40,34,6,3
"2011","N00000951 (Bellevue ward)","N00000951",106,80,37,43,0,10,10,0,16,15,1,0
"2011","N00000952 (Bellevue ward)","N00000952",176,74,12,62,4,63,61,2,27,27,0,8
"2011","N00000953 (Bellevue ward)","N00000953",117,80,26,54,2,13,12,1,21,20,1,1
"2011","N00000954 (Bellevue ward)","N00000954",121,23,10,13,0,89,88,1,7,6,1,2
"2011","N00000955 (Bellevue ward)","N00000955",158,129,58,71,1,1,0,1,27,27,0,0
"2011","N00000956 (Bellevue ward)","N00000956",215,123,33,90,7,16,4,12,67,62,5,2
"2011","N00000957 (Belmont ward)","N00000957",192,176,73,103,0,1,0,1,14,11,3,1
"2011","N00000958 (Belmont ward)","N00000958",132,97,51,46,1,11,0,11,21,20,1,2
"2011","N00000959 (Belmont ward)","N00000959",204,167,93,74,1,16,1,15,17,15,2,3
"2011","N00000960 (Belmont ward)","N00000960",192,156,74,82,2,2,0,2,30,29,1,2
"2011","N00000961 (Belmont ward)","N00000961",124,111,64,47,0,0,0,0,9,7,2,4
"2011","N00000962 (Belmont ward)","N00000962",159,64,14,50,3,80,80,0,10,10,0,2
"2011","N00000963 (Belmont ward)","N00000963",115,104,63,41,1,3,3,0,4,4,0,3
"2011","N00000964 (Belmont ward)","N00000964",129,119,70,49,0,1,1,0,7,6,1,2
"2011","N00000965 (Belmont ward)","N00000965",120,92,45,47,1,12,11,1,14,13,1,1
"2011","N00000966 (Belmont ward)","N00000966",148,130,71,59,0,1,0,1,14,14,0,3
"2011","N00000967 (Belmont ward)","N00000967",137,119,46,73,1,4,4,0,12,12,0,1
"2011","N00000968 (Belmont ward)","N00000968",103,86,27,59,0,4,2,2,13,13,0,0
"2011","N00000969 (Belmont ward)","N00000969",92,46,20,26,0,21,20,1,20,19,1,5
"2011","N00000970 (Belmont ward)","N00000970",243,95,27,68,0,78,49,29,63,60,3,7
"2011","N00000971 (Belmont ward)","N00000971",120,51,20,31,3,53,50,3,10,9,1,3
"2011","N00000972 (Belmont ward)","N00000972",129,41,13,28,2,73,71,2,8,6,2,5
"2011","N00000973 (Belmont ward)","N00000973",145,72,18,54,1,51,18,33,19,18,1,2
"2011","N00000974 (Belmont ward)","N00000974",120,34,10,24,0,76,60,16,5,5,0,5
"2011","N00000975 (Blackstaff ward)","N00000975",125,43,18,25,1,51,51,0,25,25,0,5
"2011","N00000976 (Blackstaff ward)","N00000976",74,18,6,12,0,50,48,2,4,4,0,2
"2011","N00000977 (Blackstaff ward)","N00000977",145,64,27,37,0,52,51,1,26,19,7,3
"2011","N00000978 (Blackstaff ward)","N00000978",134,38,19,19,1,37,36,1,55,51,4,3
"2011","N00000979 (Blackstaff ward)","N00000979",126,50,29,21,1,38,38,0,32,29,3,5
"2011","N00000980 (Blackstaff ward)","N00000980",128,49,31,18,1,5,5,0,72,69,3,1
"2011","N00000981 (Blackstaff ward)","N00000981",108,52,25,27,0,4,4,0,50,47,3,2
"2011","N00000982 (Blackstaff ward)","N00000982",126,45,28,17,0,12,12,0,66,64,2,3
"2011","N00000983 (Blackstaff ward)","N00000983",162,64,37,27,0,42,31,11,49,46,3,7
"2011","N00000984 (Blackstaff ward)","N00000984",160,51,31,20,0,20,19,1,86,77,9,3
"2011","N00000985 (Blackstaff ward)","N00000985",126,26,3,23,0,74,46,28,20,17,3,6
"2011","N00000986 (Blackstaff ward)","N00000986",112,26,16,10,0,52,44,8,34,33,1,0
"2011","N00000987 (Blackstaff ward)","N00000987",152,46,31,15,1,47,23,24,53,42,11,5
"2011","N00000988 (Blackstaff ward)","N00000988",74,16,7,9,2,34,34,0,19,19,0,3
"2011","N00000989 (Blackstaff ward)","N00000989",124,31,15,16,0,61,58,3,22,21,1,10
"2011","N00000990 (Blackstaff ward)","N00000990",141,41,19,22,0,43,43,0,53,51,2,4
"2011","N00000991 (Bloomfield ward)","N00000991",141,31,22,9,0,57,8,49,51,47,4,2
"2011","N00000992 (Bloomfield ward)","N00000992",265,135,53,82,5,37,8,29,82,78,4,6
"2011","N00000993 (Bloomfield ward)","N00000993",111,44,24,20,2,29,12,17,35,34,1,1
"2011","N00000994 (Bloomfield ward)","N00000994",470,169,62,107,7,160,74,86,126,121,5,8
"2011","N00000995 (Bloomfield ward)","N00000995",97,66,30,36,0,1,1,0,28,25,3,2
"2011","N00000996 (Bloomfield ward)","N00000996",123,101,44,57,3,4,2,2,14,13,1,1
"2011","N00000997 (Bloomfield ward)","N00000997",103,79,42,37,1,0,0,0,21,21,0,2
"2011","N00000998 (Bloomfield ward)","N00000998",127,102,45,57,0,3,1,2,21,20,1,1
"2011","N00000999 (Bloomfield ward)","N00000999",122,63,25,38,0,20,11,9,35,34,1,4
"2011","N00001000 (Bloomfield ward)","N00001000",129,125,61,64,0,1,1,0,3,3,0,0
"2011","N00001001 (Bloomfield ward)","N00001001",139,78,34,44,2,5,3,2,52,52,0,2
"2011","N00001002 (Bloomfield ward)","N00001002",431,231,99,132,3,35,19,16,155,149,6,7
"2011","N00001003 (Bloomfield ward)","N00001003",113,69,24,45,2,3,3,0,39,39,0,0
"2011","N00001004 (Bloomfield ward)","N00001004",143,86,37,49,3,2,2,0,51,50,1,1
"2011","N00001005 (Bloomfield ward)","N00001005",172,44,13,31,2,62,9,53,56,53,3,8
"2011","N00001006 (Botanic ward)","N00001006",148,18,10,8,1,8,4,4,116,113,3,5
"2011","N00001007 (Botanic ward)","N00001007",242,47,19,28,0,31,23,8,164,153,11,0
"2011","N00001008 (Botanic ward)","N00001008",85,16,8,8,1,2,1,1,65,63,2,1
"2011","N00001009 (Botanic ward)","N00001009",83,9,5,4,0,1,0,1,72,69,3,1
"2011","N00001010 (Botanic ward)","N00001010",124,22,17,5,1,8,3,5,92,87,5,1
"2011","N00001011 (Botanic ward)","N00001011",126,10,7,3,0,23,4,19,93,82,11,0
"2011","N00001012 (Botanic ward)","N00001012",128,25,12,13,0,21,10,11,81,68,13,1
"2011","N00001013 (Botanic ward)","N00001013",98,14,5,9,0,15,11,4,67,57,10,2
"2011","N00001014 (Botanic ward)","N00001014",107,13,8,5,0,7,4,3,87,84,3,0
"2011","N00001015 (Botanic ward)","N00001015",144,31,20,11,0,8,6,2,104,98,6,1
"2011","N00001016 (Botanic ward)","N00001016",100,18,10,8,2,5,4,1,72,70,2,3
"2011","N00001017 (Botanic ward)","N00001017",118,18,9,9,1,12,9,3,86,83,3,1
"2011","N00001018 (Botanic ward)","N00001018",115,57,31,26,3,5,2,3,49,46,3,1
"2011","N00001019 (Botanic ward)","N00001019",76,8,1,7,0,15,3,12,52,49,3,1
"2011","N00001020 (Botanic ward)","N00001020",94,8,6,2,2,31,8,23,53,50,3,0
"2011","N00001021 (Botanic ward)","N00001021",83,8,4,4,1,5,2,3,69,68,1,0
"2011","N00001022 (Botanic ward)","N00001022",272,19,6,13,1,96,3,93,152,146,6,4
"2011","N00001023 (Botanic ward)","N00001023",94,2,1,1,2,3,2,1,87,85,2,0
"2011","N00001024 (Botanic ward)","N00001024",149,7,5,2,1,5,2,3,135,133,2,1
"2011","N00001025 (Botanic ward)","N00001025",101,2,0,2,2,5,3,2,92,91,1,0
"2011","N00001026 (Botanic ward)","N00001026",103,5,2,3,1,9,3,6,88,87,1,0
"2011","N00001027 (Botanic ward)","N00001027",158,35,11,24,1,52,39,13,66,63,3,4
"2011","N00001028 (Botanic ward)","N00001028",118,32,10,22,0,77,52,25,5,5,0,4
"2011","N00001029 (Botanic ward)","N00001029",241,36,17,19,3,145,42,103,52,44,8,5
"2011","N00001030 (Botanic ward)","N00001030",177,46,19,27,0,70,39,31,59,56,3,2
"2011","N00001031 (Botanic ward)","N00001031",145,54,31,23,1,46,39,7,42,39,3,2
"2011","N00001032 (Castleview ward)","N00001032",106,56,23,33,0,33,32,1,12,11,1,5
"2011","N00001033 (Castleview ward)","N00001033",110,3,2,1,0,94,93,1,3,2,1,10
"2011","N00001034 (Castleview ward)","N00001034",143,121,53,68,1,5,4,1,15,12,3,1
"2011","N00001035 (Castleview ward)","N00001035",112,27,7,20,0,67,65,2,16,15,1,2
"2011","N00001036 (Castleview ward)","N00001036",193,71,28,43,1,71,44,27,41,39,2,9
"2011","N00001037 (Castleview ward)","N00001037",136,124,69,55,0,3,1,2,8,8,0,1
"2011","N00001038 (Castleview ward)","N00001038",271,232,89,143,0,26,26,0,9,8,1,4
"2011","N00001039 (Castleview ward)","N00001039",141,118,59,59,0,2,2,0,18,18,0,3
"2011","N00001040 (Castleview ward)","N00001040",117,63,27,36,2,30,30,0,11,10,1,11
"2011","N00001041 (Castleview ward)","N00001041",108,45,24,21,0,53,53,0,2,2,0,8
"2011","N00001042 (Castleview ward)","N00001042",295,178,76,102,1,75,74,1,26,23,3,15
"2011","N00001043 (Castleview ward)","N00001043",116,46,20,26,0,59,59,0,5,4,1,6
"2011","N00001044 (Castleview ward)","N00001044",152,90,37,53,3,26,26,0,28,27,1,5
"2011","N00001045 (Castleview ward)","N00001045",116,90,44,46,0,11,11,0,11,8,3,4
"2011","N00001046 (Cavehill ward)","N00001046",113,104,54,50,0,2,2,0,6,5,1,1
"2011","N00001047 (Cavehill ward)","N00001047",127,120,59,61,0,2,1,1,2,1,1,3
"2011","N00001048 (Cavehill ward)","N00001048",128,114,58,56,0,0,0,0,10,8,2,4
"2011","N00001049 (Cavehill ward)","N00001049",125,113,58,55,0,1,1,0,9,8,1,2
"2011","N00001050 (Cavehill ward)","N00001050",125,114,55,59,0,3,2,1,4,4,0,4
"2011","N00001051 (Cavehill ward)","N00001051",117,107,49,58,0,2,1,1,6,5,1,2
"2011","N00001052 (Cavehill ward)","N00001052",100,50,17,33,0,28,21,7,20,17,3,2
"2011","N00001053 (Cavehill ward)","N00001053",125,116,72,44,0,2,2,0,3,1,2,4
"2011","N00001054 (Cavehill ward)","N00001054",120,111,56,55,0,1,1,0,5,5,0,3
"2011","N00001055 (Cavehill ward)","N00001055",120,112,54,58,0,3,1,2,5,4,1,0
"2011","N00001056 (Cavehill ward)","N00001056",127,110,40,70,3,1,1,0,10,10,0,3
"2011","N00001057 (Cavehill ward)","N00001057",129,117,52,65,3,2,2,0,7,6,1,0
"2011","N00001058 (Cavehill ward)","N00001058",134,123,67,56,0,1,1,0,9,8,1,1
"2011","N00001059 (Cavehill ward)","N00001059",121,113,54,59,0,2,2,0,6,6,0,0
"2011","N00001060 (Cavehill ward)","N00001060",106,95,52,43,0,4,3,1,6,5,1,1
"2011","N00001061 (Cherryvalley ward)","N00001061",102,92,53,39,0,2,0,2,8,8,0,0
"2011","N00001062 (Cherryvalley ward)","N00001062",113,86,36,50,0,13,13,0,13,13,0,1
"2011","N00001063 (Cherryvalley ward)","N00001063",123,113,67,46,0,1,1,0,5,5,0,4
"2011","N00001064 (Cherryvalley ward)","N00001064",272,245,123,122,0,4,1,3,20,17,3,3
"2011","N00001065 (Cherryvalley ward)","N00001065",126,114,58,56,0,0,0,0,11,11,0,1
"2011","N00001066 (Cherryvalley ward)","N00001066",121,102,45,57,1,5,5,0,12,10,2,1
"2011","N00001067 (Cherryvalley ward)","N00001067",133,112,71,41,0,11,0,11,8,6,2,2
"2011","N00001068 (Cherryvalley ward)","N00001068",154,110,54,56,0,5,1,4,39,37,2,0
"2011","N00001069 (Cherryvalley ward)","N00001069",133,117,46,71,0,1,1,0,14,14,0,1
"2011","N00001070 (Cherryvalley ward)","N00001070",212,191,81,110,1,4,1,3,13,12,1,3
"2011","N00001071 (Cherryvalley ward)","N00001071",137,95,40,55,1,8,5,3,33,31,2,0
"2011","N00001072 (Cherryvalley ward)","N00001072",143,127,76,51,2,4,1,3,8,7,1,2
"2011","N00001073 (Cherryvalley ward)","N00001073",127,55,17,38,1,51,50,1,14,14,0,6
"2011","N00001074 (Cherryvalley ward)","N00001074",109,98,74,24,0,4,3,1,5,4,1,2
"2011","N00001075 (Cherryvalley ward)","N00001075",131,74,25,49,2,31,31,0,20,18,2,4
"2011","N00001076 (Cherryvalley ward)","N00001076",139,84,48,36,2,40,38,2,7,6,1,6
"2011","N00001077 (Cherryvalley ward)","N00001077",131,42,27,15,0,75,75,0,7,6,1,7
"2011","N00001078 (Cherryvalley ward)","N00001078",138,108,50,58,0,1,1,0,28,23,5,1
"2011","N00001079 (Chichester Park ward)","N00001079",369,156,56,100,9,73,36,37,128,123,5,3
"2011","N00001080 (Chichester Park ward)","N00001080",149,105,45,60,0,9,3,6,33,29,4,2
"2011","N00001081 (Chichester Park ward)","N00001081",168,104,50,54,4,27,24,3,31,24,7,2
"2011","N00001082 (Chichester Park ward)","N00001082",180,92,47,45,1,19,12,7,63,62,1,5
"2011","N00001083 (Chichester Park ward)","N00001083",162,123,49,74,0,25,3,22,12,12,0,2
"2011","N00001084 (Chichester Park ward)","N00001084",177,90,45,45,3,37,1,36,42,37,5,5
"2011","N00001085 (Chichester Park ward)","N00001085",438,264,103,161,1,92,20,72,76,70,6,5
"2011","N00001086 (Chichester Park ward)","N00001086",131,111,53,58,0,3,2,1,17,15,2,0
"2011","N00001087 (Chichester Park ward)","N00001087",107,78,31,47,2,10,6,4,15,12,3,2
"2011","N00001088 (Chichester Park ward)","N00001088",107,93,48,45,1,1,1,0,12,12,0,0
"2011","N00001089 (Chichester Park ward)","N00001089",136,63,29,34,0,59,55,4,8,8,0,6
"2011","N00001090 (Chichester Park ward)","N00001090",106,42,21,21,0,49,46,3,7,7,0,8
"2011","N00001091 (Cliftonville ward)","N00001091",130,121,49,72,0,3,3,0,4,3,1,2
"2011","N00001092 (Cliftonville ward)","N00001092",146,88,36,52,3,30,11,19,24,22,2,1
"2011","N00001093 (Cliftonville ward)","N00001093",232,46,15,31,2,149,45,104,25,21,4,10
"2011","N00001094 (Cliftonville ward)","N00001094",117,57,26,31,0,21,15,6,39,38,1,0
"2011","N00001095 (Cliftonville ward)","N00001095",145,88,38,50,0,11,3,8,40,35,5,6
"2011","N00001096 (Cliftonville ward)","N00001096",128,122,46,76,1,3,2,1,2,2,0,0
"2011","N00001097 (Cliftonville ward)","N00001097",121,95,44,51,0,12,11,1,14,12,2,0
"2011","N00001098 (Cliftonville ward)","N00001098",135,90,49,41,2,30,4,26,11,10,1,2
"2011","N00001099 (Cliftonville ward)","N00001099",125,96,38,58,2,1,1,0,25,24,1,1
"2011","N00001100 (Cliftonville ward)","N00001100",114,108,51,57,0,2,1,1,3,3,0,1
"2011","N00001101 (Cliftonville ward)","N00001101",120,95,33,62,1,11,11,0,12,12,0,1
"2011","N00001102 (Cliftonville ward)","N00001102",265,73,37,36,0,148,115,33,36,30,6,8
"2011","N00001103 (Cliftonville ward)","N00001103",100,33,11,22,1,25,14,11,38,32,6,3
"2011","N00001104 (Cliftonville ward)","N00001104",130,91,41,50,0,26,26,0,10,10,0,3
"2011","N00001105 (Cliftonville ward)","N00001105",129,59,16,43,0,45,30,15,22,20,2,3
"2011","N00001106 (Clonard ward)","N00001106",129,53,24,29,0,38,38,0,37,35,2,1
"2011","N00001107 (Clonard ward)","N00001107",142,73,30,43,2,44,36,8,21,17,4,2
"2011","N00001108 (Clonard ward)","N00001108",104,61,24,37,1,8,7,1,29,29,0,5
"2011","N00001109 (Clonard ward)","N00001109",145,50,12,38,0,73,63,10,13,12,1,9
"2011","N00001110 (Clonard ward)","N00001110",146,64,30,34,1,49,26,23,29,29,0,3
"2011","N00001111 (Clonard ward)","N00001111",277,103,30,73,1,132,28,104,31,27,4,10
"2011","N00001112 (Clonard ward)","N00001112",130,62,32,30,0,29,15,14,34,33,1,5
"2011","N00001113 (Clonard ward)","N00001113",600,166,43,123,1,290,184,106,125,120,5,18
"2011","N00001114 (Clonard ward)","N00001114",134,66,32,34,2,12,10,2,52,52,0,2
"2011","N00001115 (Clonard ward)","N00001115",108,67,43,24,0,13,7,6,27,25,2,1
"2011","N00001116 (Clonard ward)","N00001116",228,81,38,43,1,96,53,43,41,36,5,9
"2011","N00001117 (Crumlin ward)","N00001117",367,98,39,59,0,206,176,30,27,23,4,36
"2011","N00001118 (Crumlin ward)","N00001118",121,55,32,23,0,35,18,17,27,26,1,4
"2011","N00001119 (Crumlin ward)","N00001119",98,15,11,4,0,65,64,1,5,5,0,13
"2011","N00001120 (Crumlin ward)","N00001120",122,28,15,13,0,74,66,8,9,9,0,11
"2011","N00001121 (Crumlin ward)","N00001121",124,24,13,11,0,80,66,14,12,11,1,8
"2011","N00001122 (Crumlin ward)","N00001122",124,28,18,10,0,59,8,51,24,21,3,13
"2011","N00001123 (Crumlin ward)","N00001123",105,22,5,17,0,73,70,3,3,1,2,7
"2011","N00001124 (Crumlin ward)","N00001124",245,84,21,63,6,113,58,55,33,31,2,9
"2011","N00001125 (Crumlin ward)","N00001125",169,44,13,31,5,72,19,53,40,36,4,8
"2011","N00001126 (Crumlin ward)","N00001126",115,10,3,7,0,92,82,10,6,4,2,7
"2011","N00001127 (Crumlin ward)","N00001127",315,24,10,14,3,251,91,160,22,16,6,15
"2011","N00001128 (Crumlin ward)","N00001128",129,22,10,12,2,93,73,20,5,5,0,7
"2011","N00001129 (Crumlin ward)","N00001129",205,41,13,28,2,139,40,99,12,9,3,11
"2011","N00001130 (Duncairn ward)","N00001130",88,16,7,9,0,60,59,1,12,12,0,0
"2011","N00001131 (Duncairn ward)","N00001131",510,62,22,40,2,204,70,134,230,219,11,12
"2011","N00001132 (Duncairn ward)","N00001132",125,21,12,9,0,85,82,3,8,8,0,11
"2011","N00001133 (Duncairn ward)","N00001133",316,96,28,68,2,148,25,123,59,52,7,11
"2011","N00001134 (Duncairn ward)","N00001134",109,70,33,37,0,6,3,3,30,30,0,3
"2011","N00001135 (Duncairn ward)","N00001135",94,15,8,7,0,65,13,52,9,9,0,5
"2011","N00001136 (Duncairn ward)","N00001136",151,35,25,10,0,74,44,30,38,35,3,4
"2011","N00001137 (Duncairn ward)","N00001137",135,12,3,9,0,102,100,2,10,9,1,11
"2011","N00001138 (Duncairn ward)","N00001138",114,4,1,3,0,95,94,1,4,4,0,11
"2011","N00001139 (Duncairn ward)","N00001139",210,129,32,97,5,36,34,2,34,33,1,6
"2011","N00001140 (Duncairn ward)","N00001140",137,34,12,22,1,85,83,2,17,16,1,0
"2011","N00001141 (Duncairn ward)","N00001141",92,44,27,17,1,26,26,0,20,20,0,1
"2011","N00001142 (Duncairn ward)","N00001142",109,32,19,13,0,60,51,9,12,11,1,5
"2011","N00001143 (Duncairn ward)","N00001143",60,8,1,7,0,41,23,18,7,6,1,4
"2011","N00001144 (Duncairn ward)","N00001144",109,18,9,9,0,75,73,2,7,6,1,9
"2011","N00001145 (Falls ward)","N00001145",137,39,16,23,0,84,74,10,8,6,2,6
"2011","N00001146 (Falls ward)","N00001146",133,35,11,24,1,77,75,2,6,6,0,14
"2011","N00001147 (Falls ward)","N00001147",127,51,26,25,2,44,43,1,28,28,0,2
"2011","N00001148 (Falls ward)","N00001148",112,26,9,17,0,76,72,4,4,4,0,6
"2011","N00001149 (Falls ward)","N00001149",130,29,8,21,0,94,91,3,4,4,0,3
"2011","N00001150 (Falls ward)","N00001150",123,21,4,17,1,92,64,28,9,9,0,0
"2011","N00001151 (Falls ward)","N00001151",154,50,15,35,2,90,87,3,10,9,1,2
"2011","N00001152 (Falls ward)","N00001152",148,48,12,36,0,91,79,12,4,3,1,5
"2011","N00001153 (Falls ward)","N00001153",136,47,14,33,0,73,69,4,7,7,0,9
"2011","N00001154 (Falls ward)","N00001154",114,39,12,27,0,63,57,6,8,7,1,4
"2011","N00001155 (Falls ward)","N00001155",324,77,35,42,2,88,42,46,144,142,2,13
"2011","N00001156 (Falls ward)","N00001156",624,180,60,120,4,386,292,94,24,19,5,30
"2011","N00001157 (Falls Park ward)","N00001157",113,92,50,42,1,1,1,0,15,14,1,4
"2011","N00001158 (Falls Park ward)","N00001158",112,100,57,43,0,2,0,2,8,5,3,2
"2011","N00001159 (Falls Park ward)","N00001159",136,112,47,65,0,8,2,6,13,12,1,3
"2011","N00001160 (Falls Park ward)","N00001160",171,76,33,43,0,65,28,37,24,21,3,6
"2011","N00001161 (Falls Park ward)","N00001161",117,66,23,43,1,10,7,3,36,28,8,4
"2011","N00001162 (Falls Park ward)","N00001162",84,65,34,31,0,1,1,0,16,15,1,2
"2011","N00001163 (Falls Park ward)","N00001163",185,43,24,19,1,121,19,102,10,8,2,10
"2011","N00001164 (Falls Park ward)","N00001164",120,98,29,69,2,2,1,1,17,15,2,1
"2011","N00001165 (Falls Park ward)","N00001165",129,113,57,56,2,5,3,2,7,7,0,2
"2011","N00001166 (Falls Park ward)","N00001166",255,200,85,115,1,18,16,2,33,31,2,3
"2011","N00001167 (Falls Park ward)","N00001167",125,117,60,57,1,1,0,1,5,4,1,1
"2011","N00001168 (Falls Park ward)","N00001168",126,60,11,49,0,60,58,2,4,4,0,2
"2011","N00001169 (Falls Park ward)","N00001169",119,99,41,58,2,3,2,1,14,11,3,1
"2011","N00001170 (Falls Park ward)","N00001170",128,101,36,65,2,17,16,1,4,3,1,4
"2011","N00001171 (Falls Park ward)","N00001171",179,105,44,61,3,50,13,37,17,14,3,4
"2011","N00001172 (Falls Park ward)","N00001172",109,100,42,58,3,0,0,0,4,4,0,2
"2011","N00001173 (Finaghy ward)","N00001173",109,96,51,45,0,0,0,0,13,12,1,0
"2011","N00001174 (Finaghy ward)","N00001174",117,110,54,56,0,2,2,0,4,3,1,1
"2011","N00001175 (Finaghy ward)","N00001175",113,102,57,45,1,1,0,1,9,7,2,0
"2011","N00001176 (Finaghy ward)","N00001176",111,105,62,43,0,2,2,0,3,2,1,1
"2011","N00001177 (Finaghy ward)","N00001177",116,103,54,49,0,1,1,0,11,9,2,1
"2011","N00001178 (Finaghy ward)","N00001178",146,135,67,68,2,0,0,0,8,6,2,1
"2011","N00001179 (Finaghy ward)","N00001179",112,101,47,54,0,3,2,1,5,4,1,3
"2011","N00001180 (Finaghy ward)","N00001180",97,46,26,20,1,22,22,0,22,21,1,6
"2011","N00001181 (Finaghy ward)","N00001181",112,76,43,33,0,25,24,1,8,7,1,3
"2011","N00001182 (Finaghy ward)","N00001182",112,109,51,58,0,0,0,0,2,1,1,1
"2011","N00001183 (Finaghy ward)","N00001183",202,144,71,73,2,17,10,7,34,32,2,5
"2011","N00001184 (Finaghy ward)","N00001184",112,100,56,44,1,2,1,1,9,9,0,0
"2011","N00001185 (Finaghy ward)","N00001185",130,109,79,30,1,6,1,5,12,9,3,2
"2011","N00001186 (Finaghy ward)","N00001186",110,96,55,41,1,1,0,1,12,12,0,0
"2011","N00001187 (Finaghy ward)","N00001187",122,103,53,50,1,2,1,1,15,14,1,1
"2011","N00001188 (Fortwilliam ward)","N00001188",356,252,150,102,3,68,38,30,27,22,5,6
"2011","N00001189 (Fortwilliam ward)","N00001189",116,108,52,56,0,1,1,0,5,5,0,2
"2011","N00001190 (Fortwilliam ward)","N00001190",140,105,42,63,0,2,1,1,32,30,2,1
"2011","N00001191 (Fortwilliam ward)","N00001191",120,86,49,37,2,5,3,2,23,22,1,4
"2011","N00001192 (Fortwilliam ward)","N00001192",118,92,45,47,2,2,2,0,21,20,1,1
"2011","N00001193 (Fortwilliam ward)","N00001193",117,66,36,30,0,3,3,0,48,45,3,0
"2011","N00001194 (Fortwilliam ward)","N00001194",116,99,57,42,0,0,0,0,16,15,1,1
"2011","N00001195 (Fortwilliam ward)","N00001195",95,32,17,15,0,26,21,5,34,31,3,3
"2011","N00001196 (Fortwilliam ward)","N00001196",146,128,71,57,0,1,1,0,15,13,2,2
"2011","N00001197 (Fortwilliam ward)","N00001197",129,61,31,30,1,7,6,1,58,53,5,2
"2011","N00001198 (Fortwilliam ward)","N00001198",140,122,51,71,0,3,1,2,14,13,1,1
"2011","N00001199 (Fortwilliam ward)","N00001199",101,55,35,20,0,7,6,1,38,36,2,1
"2011","N00001200 (Fortwilliam ward)","N00001200",139,108,40,68,0,20,4,16,9,8,1,2
"2011","N00001201 (Fortwilliam ward)","N00001201",112,103,58,45,0,0,0,0,8,7,1,1
"2011","N00001202 (Glen Road ward)","N00001202",116,35,9,26,0,64,63,1,10,9,1,7
"2011","N00001203 (Glen Road ward)","N00001203",120,75,33,42,0,19,15,4,24,22,2,2
"2011","N00001204 (Glen Road ward)","N00001204",393,259,120,139,3,81,35,46,43,40,3,7
"2011","N00001205 (Glen Road ward)","N00001205",239,156,83,73,3,49,30,19,28,25,3,3
"2011","N00001206 (Glen Road ward)","N00001206",102,59,21,38,2,34,32,2,7,3,4,0
"2011","N00001207 (Glen Road ward)","N00001207",125,117,44,73,0,3,2,1,4,4,0,1
"2011","N00001208 (Glen Road ward)","N00001208",121,90,41,49,1,16,16,0,12,10,2,2
"2011","N00001209 (Glen Road ward)","N00001209",114,74,29,45,1,27,24,3,10,10,0,2
"2011","N00001210 (Glen Road ward)","N00001210",126,100,35,65,2,17,16,1,3,3,0,4
"2011","N00001211 (Glen Road ward)","N00001211",128,95,46,49,1,18,18,0,11,8,3,3
"2011","N00001212 (Glen Road ward)","N00001212",127,94,32,62,1,24,23,1,6,5,1,2
"2011","N00001213 (Glen Road ward)","N00001213",130,58,13,45,1,62,61,1,5,4,1,4
"2011","N00001214 (Glen Road ward)","N00001214",116,71,32,39,1,35,34,1,6,4,2,3
"2011","N00001215 (Glen Road ward)","N00001215",104,53,26,27,0,39,25,14,9,7,2,3
"2011","N00001216 (Glen Road ward)","N00001216",133,108,16,92,4,6,6,0,15,15,0,0
"2011","N00001217 (Glencairn ward)","N00001217",160,80,37,43,0,33,31,2,44,44,0,3
"2011","N00001218 (Glencairn ward)","N00001218",104,93,49,44,1,1,1,0,7,7,0,2
"2011","N00001219 (Glencairn ward)","N00001219",136,43,19,24,2,80,79,1,9,9,0,2
"2011","N00001220 (Glencairn ward)","N00001220",110,43,18,25,1,52,52,0,10,9,1,4
"2011","N00001221 (Glencairn ward)","N00001221",124,27,18,9,0,76,58,18,16,12,4,5
"2011","N00001222 (Glencairn ward)","N00001222",88,30,10,20,0,46,46,0,9,9,0,3
"2011","N00001223 (Glencairn ward)","N00001223",126,70,36,34,4,41,39,2,8,6,2,3
"2011","N00001224 (Glencairn ward)","N00001224",124,72,33,39,1,12,7,5,39,35,4,0
"2011","N00001225 (Glencairn ward)","N00001225",127,53,35,18,0,58,55,3,11,10,1,5
"2011","N00001226 (Glencairn ward)","N00001226",116,68,36,32,0,9,4,5,39,38,1,0
"2011","N00001227 (Glencairn ward)","N00001227",110,44,30,14,0,51,49,2,8,7,1,7
"2011","N00001228 (Glencairn ward)","N00001228",89,30,15,15,0,48,27,21,9,8,1,2
"2011","N00001229 (Glencairn ward)","N00001229",119,77,39,38,1,28,11,17,11,11,0,2
"2011","N00001230 (Glencairn ward)","N00001230",121,105,57,48,1,7,6,1,6,5,1,2
"2011","N00001231 (Glencolin ward)","N00001231",130,85,28,57,1,38,38,0,5,5,0,1
"2011","N00001232 (Glencolin ward)","N00001232",99,93,15,78,0,3,3,0,1,1,0,2
"2011","N00001233 (Glencolin ward)","N00001233",122,113,14,99,0,4,2,2,5,4,1,0
"2011","N00001234 (Glencolin ward)","N00001234",136,90,9,81,2,31,31,0,11,11,0,2
"2011","N00001235 (Glencolin ward)","N00001235",353,218,44,174,3,106,67,39,23,22,1,3
"2011","N00001236 (Glencolin ward)","N00001236",131,72,10,62,2,40,39,1,13,12,1,4
"2011","N00001237 (Glencolin ward)","N00001237",123,78,33,45,0,37,33,4,7,7,0,1
"2011","N00001238 (Glencolin ward)","N00001238",110,70,25,45,0,31,30,1,5,3,2,4
"2011","N00001239 (Glencolin ward)","N00001239",117,108,58,50,1,4,3,1,3,3,0,1
"2011","N00001240 (Glencolin ward)","N00001240",500,248,53,195,5,179,165,14,56,48,8,12
"2011","N00001241 (Glencolin ward)","N00001241",133,74,26,48,0,53,34,19,5,4,1,1
"2011","N00001242 (Glencolin ward)","N00001242",122,80,26,54,2,31,30,1,6,6,0,3
"2011","N00001243 (Glencolin ward)","N00001243",123,75,25,50,1,38,36,2,7,4,3,2
"2011","N00001244 (Glencolin ward)","N00001244",133,56,26,30,0,54,52,2,15,14,1,8
"2011","N00001245 (Glencolin ward)","N00001245",135,71,26,45,2,44,43,1,14,13,1,4
"2011","N00001246 (Highfield ward)","N00001246",261,182,64,118,10,4,4,0,64,61,3,1
"2011","N00001247 (Highfield ward)","N00001247",115,47,23,24,0,55,48,7,8,8,0,5
"2011","N00001248 (Highfield ward)","N00001248",146,133,43,90,1,1,1,0,9,7,2,2
"2011","N00001249 (Highfield ward)","N00001249",152,142,65,77,0,0,0,0,7,6,1,3
"2011","N00001250 (Highfield ward)","N00001250",165,144,33,111,3,3,3,0,15,10,5,0
"2011","N00001251 (Highfield ward)","N00001251",122,63,30,33,0,47,42,5,8,6,2,4
"2011","N00001252 (Highfield ward)","N00001252",131,89,46,43,1,19,18,1,20,18,2,2
"2011","N00001253 (Highfield ward)","N00001253",115,47,24,23,1,54,53,1,7,4,3,6
"2011","N00001254 (Highfield ward)","N00001254",113,100,40,60,0,7,4,3,6,4,2,0
"2011","N00001255 (Highfield ward)","N00001255",123,93,59,34,2,16,15,1,11,11,0,1
"2011","N00001256 (Highfield ward)","N00001256",108,101,58,43,1,3,2,1,2,2,0,1
"2011","N00001257 (Highfield ward)","N00001257",110,28,6,22,0,68,66,2,6,6,0,8
"2011","N00001258 (Highfield ward)","N00001258",118,34,13,21,0,76,75,1,3,3,0,5
"2011","N00001259 (Highfield ward)","N00001259",129,31,16,15,1,86,85,1,5,4,1,6
"2011","N00001260 (Highfield ward)","N00001260",136,37,17,20,0,88,88,0,9,8,1,2
"2011","N00001261 (Highfield ward)","N00001261",116,36,23,13,1,61,61,0,15,15,0,3
"2011","N00001262 (Highfield ward)","N00001262",165,104,45,59,3,43,42,1,15,12,3,0
"2011","N00001263 (Island ward)","N00001263",138,83,30,53,3,22,5,17,27,25,2,3
"2011","N00001264 (Island ward)","N00001264",88,22,4,18,1,35,7,28,27,26,1,3
"2011","N00001265 (Island ward)","N00001265",461,58,14,44,2,201,80,121,184,172,12,16
"2011","N00001266 (Island ward)","N00001266",90,9,1,8,0,75,12,63,1,1,0,5
"2011","N00001267 (Island ward)","N00001267",152,26,9,17,1,115,38,77,6,6,0,4
"2011","N00001268 (Island ward)","N00001268",154,24,15,9,0,115,86,29,10,8,2,5
"2011","N00001269 (Island ward)","N00001269",271,133,61,72,1,15,9,6,114,108,6,8
"2011","N00001270 (Island ward)","N00001270",154,64,27,37,0,43,12,31,41,40,1,6
"2011","N00001271 (Island ward)","N00001271",696,264,65,199,7,177,45,132,233,217,16,15
"2011","N00001272 (Island ward)","N00001272",118,71,33,38,2,5,2,3,39,39,0,1
"2011","N00001273 (Island ward)","N00001273",108,63,28,35,0,18,4,14,24,18,6,3
"2011","N00001274 (Knock ward)","N00001274",122,62,37,25,2,44,44,0,8,7,1,6
"2011","N00001275 (Knock ward)","N00001275",107,63,30,33,2,31,31,0,8,8,0,3
"2011","N00001276 (Knock ward)","N00001276",91,56,25,31,0,27,27,0,5,5,0,3
"2011","N00001277 (Knock ward)","N00001277",108,99,45,54,0,4,4,0,4,4,0,1
"2011","N00001278 (Knock ward)","N00001278",120,112,49,63,1,2,2,0,4,4,0,1
"2011","N00001279 (Knock ward)","N00001279",98,17,8,9,0,68,68,0,6,6,0,7
"2011","N00001280 (Knock ward)","N00001280",117,37,17,20,0,62,61,1,4,3,1,14
"2011","N00001281 (Knock ward)","N00001281",132,91,43,48,0,25,1,24,13,12,1,3
"2011","N00001282 (Knock ward)","N00001282",148,103,58,45,0,13,2,11,30,28,2,2
"2011","N00001283 (Knock ward)","N00001283",129,116,53,63,0,0,0,0,12,12,0,1
"2011","N00001284 (Knock ward)","N00001284",147,121,50,71,0,0,0,0,24,23,1,2
"2011","N00001285 (Knock ward)","N00001285",139,129,62,67,0,0,0,0,7,5,2,3
"2011","N00001286 (Knock ward)","N00001286",141,126,68,58,0,0,0,0,13,10,3,2
"2011","N00001287 (Knock ward)","N00001287",124,114,60,54,0,2,1,1,7,7,0,1
"2011","N00001288 (Knock ward)","N00001288",117,109,60,49,1,1,0,1,5,3,2,1
"2011","N00001289 (Knock ward)","N00001289",120,111,54,57,0,2,2,0,6,6,0,1
"2011","N00001290 (Knock ward)","N00001290",123,114,61,53,0,1,1,0,6,4,2,2
"2011","N00001291 (Ladybrook ward)","N00001291",118,99,30,69,0,9,9,0,9,8,1,1
"2011","N00001292 (Ladybrook ward)","N00001292",300,229,40,189,2,16,13,3,52,43,9,1
"2011","N00001293 (Ladybrook ward)","N00001293",128,122,51,71,0,1,1,0,4,2,2,1
"2011","N00001294 (Ladybrook ward)","N00001294",128,120,73,47,0,1,1,0,5,5,0,2
"2011","N00001295 (Ladybrook ward)","N00001295",119,109,54,55,1,0,0,0,9,8,1,0
"2011","N00001296 (Ladybrook ward)","N00001296",122,72,34,38,1,36,33,3,9,9,0,4
"2011","N00001297 (Ladybrook ward)","N00001297",130,111,47,64,0,9,5,4,5,4,1,5
"2011","N00001298 (Ladybrook ward)","N00001298",162,49,19,30,1,90,90,0,18,17,1,4
"2011","N00001299 (Ladybrook ward)","N00001299",135,73,33,40,3,43,28,15,10,9,1,6
"2011","N00001300 (Ladybrook ward)","N00001300",119,112,66,46,2,2,0,2,3,2,1,0
"2011","N00001301 (Ladybrook ward)","N00001301",132,127,70,57,0,1,0,1,4,4,0,0
"2011","N00001302 (Ladybrook ward)","N00001302",257,76,17,59,1,157,67,90,15,13,2,8
"2011","N00001303 (Ladybrook ward)","N00001303",133,58,20,38,1,62,59,3,5,3,2,7
"2011","N00001304 (Ladybrook ward)","N00001304",125,112,59,53,0,6,4,2,5,5,0,2
"2011","N00001305 (Ladybrook ward)","N00001305",119,103,59,44,0,4,2,2,10,8,2,2
"2011","N00001306 (Ladybrook ward)","N00001306",106,24,8,16,0,70,62,8,7,6,1,5
"2011","N00001307 (Ladybrook ward)","N00001307",130,43,4,39,2,69,31,38,15,7,8,1
"2011","N00001308 (Legoniel ward)","N00001308",210,136,60,76,1,59,29,30,11,9,2,3
"2011","N00001309 (Legoniel ward)","N00001309",153,70,23,47,0,54,51,3,24,20,4,5
"2011","N00001310 (Legoniel ward)","N00001310",335,212,74,138,11,69,6,63,40,37,3,3
"2011","N00001311 (Legoniel ward)","N00001311",120,22,5,17,3,82,80,2,8,8,0,5
"2011","N00001312 (Legoniel ward)","N00001312",244,65,15,50,6,101,85,16,66,64,2,6
"2011","N00001313 (Legoniel ward)","N00001313",195,102,29,73,6,40,40,0,41,40,1,6
"2011","N00001314 (Legoniel ward)","N00001314",142,64,11,53,3,52,48,4,19,19,0,4
"2011","N00001315 (Legoniel ward)","N00001315",114,73,33,40,1,26,24,2,6,5,1,8
"2011","N00001316 (Legoniel ward)","N00001316",194,54,25,29,2,92,67,25,38,37,1,8
"2011","N00001317 (Legoniel ward)","N00001317",115,93,54,39,0,5,4,1,16,16,0,1
"2011","N00001318 (Legoniel ward)","N00001318",133,71,39,32,2,14,11,3,38,35,3,8
"2011","N00001319 (Legoniel ward)","N00001319",118,87,37,50,0,7,5,2,19,17,2,5
"2011","N00001320 (Legoniel ward)","N00001320",101,93,53,40,0,2,1,1,5,5,0,1
"2011","N00001321 (Legoniel ward)","N00001321",108,90,43,47,0,10,10,0,8,7,1,0
"2011","N00001322 (Legoniel ward)","N00001322",133,49,18,31,0,59,31,28,23,18,5,2
"2011","N00001323 (Legoniel ward)","N00001323",121,76,36,40,0,19,18,1,20,18,2,6
"2011","N00001324 (Legoniel ward)","N00001324",113,95,60,35,0,3,2,1,15,14,1,0
"2011","N00001325 (Malone ward)","N00001325",491,389,202,187,1,7,3,4,86,79,7,8
"2011","N00001326 (Malone ward)","N00001326",125,115,82,33,0,1,0,1,8,7,1,1
"2011","N00001327 (Malone ward)","N00001327",121,117,74,43,0,2,2,0,2,2,0,0
"2011","N00001328 (Malone ward)","N00001328",378,275,156,119,1,31,5,26,67,63,4,4
"2011","N00001329 (Malone ward)","N00001329",116,95,48,47,0,2,0,2,18,17,1,1
"2011","N00001330 (Malone ward)","N00001330",124,102,59,43,0,2,1,1,17,14,3,3
"2011","N00001331 (Malone ward)","N00001331",116,87,39,48,0,0,0,0,27,26,1,2
"2011","N00001332 (Malone ward)","N00001332",103,31,15,16,0,3,3,0,67,64,3,2
"2011","N00001333 (Malone ward)","N00001333",131,104,56,48,0,1,1,0,25,22,3,1
"2011","N00001334 (Malone ward)","N00001334",140,99,63,36,0,2,1,1,38,32,6,1
"2011","N00001335 (Malone ward)","N00001335",121,42,24,18,1,4,3,1,74,68,6,0
"2011","N00001336 (Malone ward)","N00001336",108,92,43,49,0,2,1,1,14,13,1,0
"2011","N00001337 (Malone ward)","N00001337",121,100,49,51,0,1,1,0,18,15,3,2
"2011","N00001338 (Musgrave ward)","N00001338",125,94,47,47,1,18,18,0,10,9,1,2
"2011","N00001339 (Musgrave ward)","N00001339",147,95,34,61,0,36,35,1,12,11,1,4
"2011","N00001340 (Musgrave ward)","N00001340",378,179,85,94,1,145,121,24,43,40,3,10
"2011","N00001341 (Musgrave ward)","N00001341",110,100,46,54,0,1,0,1,9,8,1,0
"2011","N00001342 (Musgrave ward)","N00001342",126,120,52,68,0,0,0,0,5,5,0,1
"2011","N00001343 (Musgrave ward)","N00001343",104,89,38,51,0,3,3,0,9,9,0,3
"2011","N00001344 (Musgrave ward)","N00001344",117,110,46,64,1,2,2,0,4,3,1,0
"2011","N00001345 (Musgrave ward)","N00001345",96,89,59,30,0,2,1,1,4,4,0,1
"2011","N00001346 (Musgrave ward)","N00001346",341,265,134,131,2,7,4,3,61,61,0,6
"2011","N00001347 (Musgrave ward)","N00001347",208,129,45,84,3,2,2,0,73,73,0,1
"2011","N00001348 (Musgrave ward)","N00001348",128,100,39,61,0,2,2,0,25,20,5,1
"2011","N00001349 (Musgrave ward)","N00001349",119,73,39,34,2,0,0,0,41,35,6,3
"2011","N00001350 (New Lodge ward)","N00001350",413,129,73,56,2,244,185,59,24,19,5,14
"2011","N00001351 (New Lodge ward)","N00001351",173,63,23,40,0,95,74,21,6,5,1,9
"2011","N00001352 (New Lodge ward)","N00001352",137,33,20,13,1,60,42,18,36,35,1,7
"2011","N00001353 (New Lodge ward)","N00001353",144,12,3,9,0,122,44,78,8,5,3,2
"2011","N00001354 (New Lodge ward)","N00001354",397,114,52,62,3,241,233,8,18,16,2,21
"2011","N00001355 (New Lodge ward)","N00001355",124,50,20,30,1,57,48,9,15,13,2,1
"2011","N00001356 (New Lodge ward)","N00001356",112,27,10,17,1,72,72,0,5,5,0,7
"2011","N00001357 (New Lodge ward)","N00001357",98,4,1,3,0,87,85,2,1,1,0,6
"2011","N00001358 (New Lodge ward)","N00001358",163,52,27,25,0,76,67,9,31,30,1,4
"2011","N00001359 (New Lodge ward)","N00001359",120,54,21,33,0,47,44,3,16,16,0,3
"2011","N00001360 (New Lodge ward)","N00001360",116,36,20,16,2,49,23,26,24,22,2,5
"2011","N00001361 (New Lodge ward)","N00001361",113,48,21,27,1,43,39,4,16,15,1,5
"2011","N00001362 (New Lodge ward)","N00001362",134,17,6,11,0,99,77,22,5,4,1,13
"2011","N00001363 (Orangefield ward)","N00001363",119,102,48,54,1,1,1,0,13,12,1,2
"2011","N00001364 (Orangefield ward)","N00001364",251,160,59,101,2,28,6,22,57,50,7,4
"2011","N00001365 (Orangefield ward)","N00001365",174,140,48,92,0,3,0,3,30,25,5,1
"2011","N00001366 (Orangefield ward)","N00001366",119,101,42,59,0,2,0,2,16,15,1,0
"2011","N00001367 (Orangefield ward)","N00001367",164,85,42,43,3,50,17,33,26,22,4,0
"2011","N00001368 (Orangefield ward)","N00001368",126,115,58,57,0,3,1,2,7,5,2,1
"2011","N00001369 (Orangefield ward)","N00001369",165,133,68,65,1,13,2,11,15,14,1,3
"2011","N00001370 (Orangefield ward)","N00001370",187,124,52,72,0,48,9,39,13,10,3,2
"2011","N00001371 (Orangefield ward)","N00001371",111,95,27,68,2,2,1,1,11,10,1,1
"2011","N00001372 (Orangefield ward)","N00001372",247,233,109,124,1,1,1,0,12,11,1,0
"2011","N00001373 (Orangefield ward)","N00001373",114,103,53,50,0,2,0,2,7,7,0,2
"2011","N00001374 (Orangefield ward)","N00001374",112,104,46,58,0,1,1,0,6,6,0,1
"2011","N00001375 (Orangefield ward)","N00001375",165,92,40,52,5,53,3,50,13,13,0,2
"2011","N00001376 (Orangefield ward)","N00001376",96,63,25,38,2,3,3,0,25,24,1,3
"2011","N00001377 (Orangefield ward)","N00001377",115,103,58,45,1,4,2,2,7,5,2,0
"2011","N00001378 (Orangefield ward)","N00001378",106,87,33,54,0,4,2,2,14,11,3,1
"2011","N00001379 (Orangefield ward)","N00001379",110,91,47,44,0,4,0,4,15,13,2,0
"2011","N00001380 (Ravenhill ward)","N00001380",133,93,36,57,1,0,0,0,39,38,1,0
"2011","N00001381 (Ravenhill ward)","N00001381",182,84,24,60,2,12,3,9,84,79,5,0
"2011","N00001382 (Ravenhill ward)","N00001382",115,96,44,52,0,0,0,0,15,15,0,4
"2011","N00001383 (Ravenhill ward)","N00001383",100,88,43,45,0,6,5,1,5,4,1,1
"2011","N00001384 (Ravenhill ward)","N00001384",117,100,38,62,0,1,1,0,15,15,0,1
"2011","N00001385 (Ravenhill ward)","N00001385",132,113,51,62,0,3,3,0,16,16,0,0
"2011","N00001386 (Ravenhill ward)","N00001386",262,154,55,99,5,8,3,5,92,85,7,3
"2011","N00001387 (Ravenhill ward)","N00001387",130,73,23,50,1,8,4,4,48,44,4,0
"2011","N00001388 (Ravenhill ward)","N00001388",115,72,38,34,1,15,14,1,23,18,5,4
"2011","N00001389 (Ravenhill ward)","N00001389",98,58,23,35,0,2,2,0,38,37,1,0
"2011","N00001390 (Ravenhill ward)","N00001390",107,97,47,50,1,0,0,0,8,7,1,1
"2011","N00001391 (Ravenhill ward)","N00001391",107,100,47,53,1,1,1,0,5,4,1,0
"2011","N00001392 (Ravenhill ward)","N00001392",132,50,21,29,3,28,5,23,47,46,1,4
"2011","N00001393 (Ravenhill ward)","N00001393",142,82,27,55,4,3,3,0,52,50,2,1
"2011","N00001394 (Ravenhill ward)","N00001394",122,85,36,49,0,1,0,1,35,33,2,1
"2011","N00001395 (Ravenhill ward)","N00001395",123,98,48,50,0,1,0,1,23,21,2,1
"2011","N00001396 (Ravenhill ward)","N00001396",320,115,33,82,2,17,11,6,184,177,7,2
"2011","N00001397 (Ravenhill ward)","N00001397",119,57,27,30,0,27,3,24,32,30,2,3
"2011","N00001398 (Ravenhill ward)","N00001398",131,81,40,41,2,5,2,3,43,35,8,0
"2011","N00001399 (Rosetta ward)","N00001399",363,260,118,142,0,39,6,33,55,48,7,9
"2011","N00001400 (Rosetta ward)","N00001400",137,123,67,56,0,1,0,1,13,12,1,0
"2011","N00001401 (Rosetta ward)","N00001401",442,227,73,154,4,83,39,44,117,102,15,11
"2011","N00001402 (Rosetta ward)","N00001402",292,209,79,130,0,8,5,3,72,70,2,3
"2011","N00001403 (Rosetta ward)","N00001403",135,93,41,52,1,2,2,0,36,33,3,3
"2011","N00001404 (Rosetta ward)","N00001404",295,159,69,90,2,29,2,27,98,84,14,7
"2011","N00001405 (Rosetta ward)","N00001405",114,55,24,31,0,43,43,0,13,13,0,3
"2011","N00001406 (Rosetta ward)","N00001406",112,66,22,44,2,23,23,0,16,14,2,5
"2011","N00001407 (Rosetta ward)","N00001407",121,42,17,25,0,31,3,28,45,41,4,3
"2011","N00001408 (Rosetta ward)","N00001408",211,142,61,81,2,4,2,2,61,58,3,2
"2011","N00001409 (Rosetta ward)","N00001409",111,91,36,55,0,2,2,0,17,17,0,1
"2011","N00001410 (Rosetta ward)","N00001410",125,108,53,55,0,4,3,1,10,8,2,3
"2011","N00001411 (Rosetta ward)","N00001411",123,102,49,53,0,3,1,2,17,17,0,1
"2011","N00001412 (Rosetta ward)","N00001412",102,30,16,14,0,48,13,35,19,19,0,5
"2011","N00001413 (Rosetta ward)","N00001413",120,101,51,50,0,4,3,1,12,12,0,3
"2011","N00001414 (Rosetta ward)","N00001414",112,92,40,52,0,2,2,0,18,18,0,0
"2011","N00001415 (Shaftesbury ward)","N00001415",115,40,12,28,0,63,62,1,6,6,0,6
"2011","N00001416 (Shaftesbury ward)","N00001416",472,136,37,99,1,87,50,37,227,213,14,21
"2011","N00001417 (Shaftesbury ward)","N00001417",148,23,9,14,0,107,70,37,8,6,2,10
"2011","N00001418 (Shaftesbury ward)","N00001418",321,109,32,77,1,117,84,33,83,80,3,11
"2011","N00001419 (Shaftesbury ward)","N00001419",116,36,13,23,0,42,40,2,33,31,2,5
"2011","N00001420 (Shaftesbury ward)","N00001420",132,21,5,16,0,92,89,3,8,6,2,11
"2011","N00001421 (Shaftesbury ward)","N00001421",708,183,76,107,5,192,125,67,299,283,16,29
"2011","N00001422 (Shaftesbury ward)","N00001422",115,17,6,11,0,86,48,38,5,4,1,7
"2011","N00001423 (Shaftesbury ward)","N00001423",209,36,12,24,0,147,69,78,12,7,5,14
"2011","N00001424 (Shaftesbury ward)","N00001424",114,17,9,8,0,80,77,3,11,10,1,6
"2011","N00001425 (Shaftesbury ward)","N00001425",124,30,13,17,1,71,71,0,11,8,3,11
"2011","N00001426 (Shaftesbury ward)","N00001426",118,21,7,14,0,81,70,11,7,7,0,9
"2011","N00001427 (Shaftesbury ward)","N00001427",123,38,11,27,0,71,71,0,9,6,3,5
"2011","N00001428 (Shaftesbury ward)","N00001428",128,37,17,20,0,53,53,0,31,26,5,7
"2011","N00001429 (Shaftesbury ward)","N00001429",544,97,53,44,1,188,142,46,220,210,10,38
"2011","N00001430 (Shaftesbury ward)","N00001430",129,25,12,13,0,84,80,4,12,10,2,8
"2011","N00001431 (Shankill ward)","N00001431",136,54,13,41,1,57,31,26,20,15,5,4
"2011","N00001432 (Shankill ward)","N00001432",138,20,4,16,2,89,67,22,18,18,0,9
"2011","N00001433 (Shankill ward)","N00001433",136,56,9,47,0,45,36,9,28,28,0,7
"2011","N00001434 (Shankill ward)","N00001434",134,36,6,30,0,73,49,24,15,13,2,10
"2011","N00001435 (Shankill ward)","N00001435",128,13,2,11,0,99,94,5,7,7,0,9
"2011","N00001436 (Shankill ward)","N00001436",130,20,6,14,0,85,54,31,9,7,2,16
"2011","N00001437 (Shankill ward)","N00001437",96,10,4,6,1,83,69,14,0,0,0,2
"2011","N00001438 (Shankill ward)","N00001438",139,29,13,16,0,95,89,6,2,2,0,13
"2011","N00001439 (Shankill ward)","N00001439",163,41,14,27,1,79,73,6,26,25,1,16
"2011","N00001440 (Shankill ward)","N00001440",141,27,12,15,1,88,57,31,7,7,0,18
"2011","N00001441 (Shankill ward)","N00001441",135,19,5,14,0,105,92,13,4,4,0,7
"2011","N00001442 (Shankill ward)","N00001442",115,26,13,13,0,76,74,2,8,7,1,5
"2011","N00001443 (Shankill ward)","N00001443",115,20,10,10,0,68,55,13,19,14,5,8
"2011","N00001444 (Shankill ward)","N00001444",155,18,8,10,0,123,97,26,3,2,1,11
"2011","N00001445 (Stormont ward)","N00001445",152,131,72,59,0,2,0,2,18,15,3,1
"2011","N00001446 (Stormont ward)","N00001446",132,126,77,49,1,0,0,0,3,2,1,2
"2011","N00001447 (Stormont ward)","N00001447",124,112,80,32,0,0,0,0,11,10,1,1
"2011","N00001448 (Stormont ward)","N00001448",133,125,65,60,0,2,2,0,3,3,0,3
"2011","N00001449 (Stormont ward)","N00001449",130,118,68,50,0,1,1,0,9,9,0,2
"2011","N00001450 (Stormont ward)","N00001450",118,110,72,38,2,1,1,0,4,4,0,1
"2011","N00001451 (Stormont ward)","N00001451",114,74,49,25,0,26,3,23,8,5,3,6
"2011","N00001452 (Stormont ward)","N00001452",124,117,73,44,0,3,3,0,4,4,0,0
"2011","N00001453 (Stormont ward)","N00001453",134,128,79,49,0,4,2,2,0,0,0,2
"2011","N00001454 (Stormont ward)","N00001454",117,108,66,42,0,1,0,1,6,5,1,2
"2011","N00001455 (Stormont ward)","N00001455",107,85,41,44,0,5,1,4,15,13,2,2
"2011","N00001456 (Stormont ward)","N00001456",141,112,61,51,0,0,0,0,28,28,0,1
"2011","N00001457 (Stormont ward)","N00001457",125,116,64,52,0,2,1,1,6,5,1,1
"2011","N00001458 (Stormont ward)","N00001458",130,96,41,55,0,10,7,3,23,20,3,1
"2011","N00001459 (Stormont ward)","N00001459",129,112,60,52,0,2,2,0,11,10,1,4
"2011","N00001460 (Stormont ward)","N00001460",263,181,85,96,2,39,39,0,35,32,3,6
"2011","N00001461 (Stranmillis ward)","N00001461",127,111,62,49,0,1,0,1,14,14,0,1
"2011","N00001462 (Stranmillis ward)","N00001462",137,118,65,53,0,0,0,0,17,17,0,2
"2011","N00001463 (Stranmillis ward)","N00001463",138,111,65,46,0,1,1,0,25,25,0,1
"2011","N00001464 (Stranmillis ward)","N00001464",128,115,61,54,0,4,3,1,7,7,0,2
"2011","N00001465 (Stranmillis ward)","N00001465",159,137,84,53,0,2,2,0,17,15,2,3
"2011","N00001466 (Stranmillis ward)","N00001466",105,57,36,21,0,6,4,2,41,39,2,1
"2011","N00001467 (Stranmillis ward)","N00001467",104,84,60,24,0,3,3,0,15,15,0,2
"2011","N00001468 (Stranmillis ward)","N00001468",111,38,32,6,1,3,2,1,68,60,8,1
"2011","N00001469 (Stranmillis ward)","N00001469",114,39,25,14,0,3,2,1,71,67,4,1
"2011","N00001470 (Stranmillis ward)","N00001470",134,23,16,7,1,2,2,0,106,101,5,2
"2011","N00001471 (Stranmillis ward)","N00001471",143,23,11,12,3,1,0,1,115,107,8,1
"2011","N00001472 (Stranmillis ward)","N00001472",238,180,76,104,1,4,2,2,50,43,7,3
"2011","N00001473 (Stranmillis ward)","N00001473",209,85,41,44,0,11,2,9,110,108,2,3
"2011","N00001474 (Stranmillis ward)","N00001474",113,93,56,37,1,2,2,0,16,13,3,1
"2011","N00001475 (Stranmillis ward)","N00001475",141,75,45,30,0,2,2,0,63,61,2,1
"2011","N00001476 (Stranmillis ward)","N00001476",128,82,45,37,2,3,2,1,39,38,1,2
"2011","N00001477 (Stranmillis ward)","N00001477",113,92,49,43,0,2,2,0,17,17,0,2
"2011","N00001478 (Stranmillis ward)","N00001478",132,104,56,48,0,0,0,0,27,26,1,1
"2011","N00001479 (Stranmillis ward)","N00001479",132,103,57,46,0,2,1,1,26,23,3,1
"2011","N00001480 (Sydenham ward)","N00001480",240,75,30,45,1,121,66,55,34,32,2,9
"2011","N00001481 (Sydenham ward)","N00001481",105,36,12,24,0,62,59,3,3,3,0,4
"2011","N00001482 (Sydenham ward)","N00001482",139,91,46,45,2,6,4,2,38,38,0,2
"2011","N00001483 (Sydenham ward)","N00001483",124,85,27,58,3,9,9,0,23,23,0,4
"2011","N00001484 (Sydenham ward)","N00001484",112,55,16,39,2,25,17,8,28,27,1,2
"2011","N00001485 (Sydenham ward)","N00001485",130,78,29,49,1,3,3,0,47,46,1,1
"2011","N00001486 (Sydenham ward)","N00001486",127,106,45,61,1,2,2,0,16,15,1,2
"2011","N00001487 (Sydenham ward)","N00001487",138,116,60,56,1,4,3,1,16,15,1,1
"2011","N00001488 (Sydenham ward)","N00001488",117,92,30,62,2,7,7,0,16,15,1,0
"2011","N00001489 (Sydenham ward)","N00001489",121,104,62,42,0,3,2,1,13,12,1,1
"2011","N00001490 (Sydenham ward)","N00001490",101,51,17,34,1,11,10,1,37,29,8,1
"2011","N00001491 (Sydenham ward)","N00001491",140,42,19,23,0,79,15,64,15,12,3,4
"2011","N00001492 (Sydenham ward)","N00001492",115,47,19,28,1,55,32,23,11,10,1,1
"2011","N00001493 (Sydenham ward)","N00001493",121,92,34,58,0,2,1,1,26,24,2,1
"2011","N00001494 (Sydenham ward)","N00001494",96,64,20,44,1,5,3,2,26,26,0,0
"2011","N00001495 (Sydenham ward)","N00001495",134,73,31,42,1,26,20,6,27,21,6,7
"2011","N00001496 (Sydenham ward)","N00001496",150,69,18,51,3,15,3,12,58,53,5,5
"2011","N00001497 (Sydenham ward)","N00001497",106,69,18,51,1,3,2,1,33,31,2,0
"2011","N00001498 (The Mount ward)","N00001498",198,25,5,20,2,101,73,28,59,56,3,11
"2011","N00001499 (The Mount ward)","N00001499",144,38,15,23,2,53,32,21,44,42,2,7
"2011","N00001500 (The Mount ward)","N00001500",147,29,12,17,0,83,13,70,31,22,9,4
"2011","N00001501 (The Mount ward)","N00001501",274,53,25,28,4,117,100,17,91,91,0,9
"2011","N00001502 (The Mount ward)","N00001502",196,81,26,55,2,74,72,2,35,35,0,4
"2011","N00001503 (The Mount ward)","N00001503",113,39,16,23,1,53,51,2,9,9,0,11
"2011","N00001504 (The Mount ward)","N00001504",106,22,12,10,0,67,66,1,14,14,0,3
"2011","N00001505 (The Mount ward)","N00001505",212,47,17,30,3,58,40,18,98,94,4,6
"2011","N00001506 (The Mount ward)","N00001506",128,39,20,19,0,28,28,0,59,57,2,2
"2011","N00001507 (The Mount ward)","N00001507",115,28,12,16,0,68,66,2,11,10,1,8
"2011","N00001508 (The Mount ward)","N00001508",207,58,12,46,2,64,36,28,80,74,6,3
"2011","N00001509 (The Mount ward)","N00001509",201,59,19,40,2,93,33,60,39,37,2,8
"2011","N00001510 (The Mount ward)","N00001510",122,67,29,38,1,27,12,15,26,24,2,1
"2011","N00001511 (The Mount ward)","N00001511",281,55,27,28,0,139,39,100,73,67,6,14
"2011","N00001512 (The Mount ward)","N00001512",137,53,21,32,0,29,11,18,53,48,5,2
"2011","N00001513 (The Mount ward)","N00001513",124,43,13,30,0,24,17,7,53,50,3,4
"2011","N00001514 (Upper Malone ward)","N00001514",109,69,35,34,1,22,22,0,16,15,1,1
"2011","N00001515 (Upper Malone ward)","N00001515",131,124,86,38,0,0,0,0,5,5,0,2
"2011","N00001516 (Upper Malone ward)","N00001516",127,121,88,33,0,1,1,0,3,3,0,2
"2011","N00001517 (Upper Malone ward)","N00001517",153,133,92,41,0,3,3,0,17,14,3,0
"2011","N00001518 (Upper Malone ward)","N00001518",174,156,80,76,0,4,2,2,14,14,0,0
"2011","N00001519 (Upper Malone ward)","N00001519",134,64,31,33,1,55,51,4,13,11,2,1
"2011","N00001520 (Upper Malone ward)","N00001520",114,31,7,24,0,73,73,0,9,7,2,1
"2011","N00001521 (Upper Malone ward)","N00001521",106,37,10,27,1,56,55,1,8,8,0,4
"2011","N00001522 (Upper Malone ward)","N00001522",115,91,47,44,0,12,10,2,9,9,0,3
"2011","N00001523 (Upper Malone ward)","N00001523",106,24,9,15,0,71,56,15,9,8,1,2
"2011","N00001524 (Upper Malone ward)","N00001524",111,30,9,21,0,68,68,0,9,9,0,4
"2011","N00001525 (Upper Malone ward)","N00001525",100,65,28,37,2,21,20,1,6,6,0,6
"2011","N00001526 (Upper Malone ward)","N00001526",112,53,27,26,1,47,46,1,8,5,3,3
"2011","N00001527 (Upper Malone ward)","N00001527",115,62,34,28,0,22,21,1,24,24,0,7
"2011","N00001528 (Upper Malone ward)","N00001528",123,86,34,52,0,2,2,0,34,31,3,1
"2011","N00001529 (Upper Malone ward)","N00001529",134,81,39,42,1,31,24,7,16,15,1,5
"2011","N00001530 (Upper Malone ward)","N00001530",165,139,69,70,0,1,0,1,25,22,3,0
"2011","N00001531 (Upper Springfield ward)","N00001531",112,49,13,36,0,57,57,0,1,1,0,5
"2011","N00001532 (Upper Springfield ward)","N00001532",148,114,38,76,3,17,8,9,11,7,4,3
"2011","N00001533 (Upper Springfield ward)","N00001533",271,146,60,86,0,101,79,22,18,16,2,6
"2011","N00001534 (Upper Springfield ward)","N00001534",132,66,29,37,0,57,57,0,7,7,0,2
"2011","N00001535 (Upper Springfield ward)","N00001535",148,28,5,23,1,111,93,18,5,4,1,3
"2011","N00001536 (Upper Springfield ward)","N00001536",126,77,29,48,1,40,29,11,3,3,0,5
"2011","N00001537 (Upper Springfield ward)","N00001537",128,36,15,21,1,84,75,9,2,2,0,5
"2011","N00001538 (Upper Springfield ward)","N00001538",128,117,58,59,3,0,0,0,7,6,1,1
"2011","N00001539 (Upper Springfield ward)","N00001539",116,56,15,41,2,49,49,0,6,6,0,3
"2011","N00001540 (Upper Springfield ward)","N00001540",136,64,16,48,1,60,39,21,5,4,1,6
"2011","N00001541 (Upper Springfield ward)","N00001541",118,32,10,22,1,75,27,48,6,4,2,4
"2011","N00001542 (Upper Springfield ward)","N00001542",121,56,18,38,1,59,57,2,4,4,0,1
"2011","N00001543 (Upper Springfield ward)","N00001543",133,60,27,33,0,58,56,2,11,10,1,4
"2011","N00001544 (Upper Springfield ward)","N00001544",115,66,27,39,0,41,39,2,4,3,1,4
"2011","N00001545 (Water Works ward)","N00001545",139,69,30,39,1,47,34,13,19,19,0,3
"2011","N00001546 (Water Works ward)","N00001546",125,58,23,35,1,39,18,21,23,19,4,4
"2011","N00001547 (Water Works ward)","N00001547",156,64,26,38,1,42,16,26,46,41,5,3
"2011","N00001548 (Water Works ward)","N00001548",179,29,18,11,0,78,5,73,67,63,4,5
"2011","N00001549 (Water Works ward)","N00001549",167,28,15,13,0,110,20,90,28,24,4,1
"2011","N00001550 (Water Works ward)","N00001550",108,27,18,9,1,57,12,45,22,21,1,1
"2011","N00001551 (Water Works ward)","N00001551",151,49,24,25,2,75,24,51,19,15,4,6
"2011","N00001552 (Water Works ward)","N00001552",156,102,45,57,1,29,5,24,19,17,2,5
"2011","N00001553 (Water Works ward)","N00001553",162,12,4,8,1,89,14,75,55,52,3,5
"2011","N00001554 (Water Works ward)","N00001554",151,67,34,33,0,46,8,38,33,33,0,5
"2011","N00001555 (Water Works ward)","N00001555",112,26,8,18,1,74,61,13,6,6,0,5
"2011","N00001556 (Water Works ward)","N00001556",96,64,23,41,3,18,10,8,10,8,2,1
"2011","N00001557 (Water Works ward)","N00001557",124,27,10,17,0,80,59,21,9,6,3,8
"2011","N00001558 (Water Works ward)","N00001558",106,29,11,18,0,34,6,28,40,40,0,3
"2011","N00001559 (Water Works ward)","N00001559",149,67,31,36,0,29,3,26,48,43,5,5
"2011","N00001560 (Water Works ward)","N00001560",101,54,17,37,1,20,9,11,24,23,1,2
"2011","N00001561 (Water Works ward)","N00001561",100,61,23,38,0,16,4,12,23,21,2,0
"2011","N00001562 (Water Works ward)","N00001562",110,23,10,13,1,53,8,45,32,32,0,1
"2011","N00001563 (Water Works ward)","N00001563",109,15,6,9,0,81,2,79,7,7,0,6
"2011","N00001564 (Water Works ward)","N00001564",140,72,36,36,1,32,3,29,33,31,2,2
"2011","N00001565 (Whiterock ward)","N00001565",143,67,25,42,2,53,47,6,13,13,0,8
"2011","N00001566 (Whiterock ward)","N00001566",141,83,32,51,1,35,30,5,19,18,1,3
"2011","N00001567 (Whiterock ward)","N00001567",105,58,22,36,0,38,37,1,6,6,0,3
"2011","N00001568 (Whiterock ward)","N00001568",107,72,19,53,2,7,5,2,25,22,3,1
"2011","N00001569 (Whiterock ward)","N00001569",124,70,21,49,0,12,11,1,37,37,0,5
"2011","N00001570 (Whiterock ward)","N00001570",418,67,11,56,2,294,96,198,37,31,6,18
"2011","N00001571 (Whiterock ward)","N00001571",144,43,7,36,0,91,72,19,6,4,2,4
"2011","N00001572 (Whiterock ward)","N00001572",126,38,17,21,0,75,73,2,4,4,0,9
"2011","N00001573 (Whiterock ward)","N00001573",154,51,14,37,0,83,59,24,12,10,2,8
"2011","N00001574 (Whiterock ward)","N00001574",118,34,16,18,0,72,71,1,4,4,0,8
"2011","N00001575 (Whiterock ward)","N00001575",110,38,22,16,0,64,60,4,7,6,1,1
"2011","N00001576 (Whiterock ward)","N00001576",124,74,18,56,0,47,46,1,1,1,0,2
"2011","N00001577 (Whiterock ward)","N00001577",123,52,10,42,1,58,56,2,4,2,2,8
"2011","N00001578 (Whiterock ward)","N00001578",114,48,15,33,1,52,52,0,7,7,0,6
"2011","N00001579 (Windsor ward)","N00001579",140,53,27,26,0,4,2,2,79,77,2,4
"2011","N00001580 (Windsor ward)","N00001580",158,74,47,27,1,3,3,0,73,72,1,7
"2011","N00001581 (Windsor ward)","N00001581",111,85,49,36,0,1,1,0,23,21,2,2
"2011","N00001582 (Windsor ward)","N00001582",107,56,31,25,0,2,1,1,47,44,3,2
"2011","N00001583 (Windsor ward)","N00001583",125,37,16,21,0,1,0,1,87,84,3,0
"2011","N00001584 (Windsor ward)","N00001584",107,37,19,18,1,36,35,1,30,29,1,3
"2011","N00001585 (Windsor ward)","N00001585",136,15,10,5,2,6,3,3,112,109,3,1
"2011","N00001586 (Windsor ward)","N00001586",142,44,36,8,0,16,1,15,77,66,11,5
"2011","N00001587 (Windsor ward)","N00001587",142,37,18,19,1,1,1,0,100,95,5,3
"2011","N00001588 (Windsor ward)","N00001588",135,29,12,17,0,13,2,11,90,83,7,3
"2011","N00001589 (Windsor ward)","N00001589",118,48,30,18,0,12,1,11,56,52,4,2
"2011","N00001590 (Windsor ward)","N00001590",147,33,15,18,2,2,2,0,107,104,3,3
"2011","N00001591 (Windsor ward)","N00001591",128,11,1,10,0,1,1,0,114,111,3,2
"2011","N00001592 (Windsor ward)","N00001592",140,34,17,17,0,41,17,24,62,58,4,3
"2011","N00001593 (Windsor ward)","N00001593",194,30,12,18,4,12,9,3,144,137,7,4
"2011","N00001594 (Windsor ward)","N00001594",142,34,13,21,2,16,12,4,90,81,9,0
"2011","N00001595 (Windsor ward)","N00001595",108,18,8,10,0,11,6,5,78,73,5,1
"2011","N00001596 (Windsor ward)","N00001596",126,20,11,9,0,4,4,0,101,99,2,1
"2011","N00001597 (Windsor ward)","N00001597",111,22,13,9,3,7,4,3,77,71,6,2
"2011","N00001598 (Windsor ward)","N00001598",139,22,9,13,3,16,15,1,96,86,10,2
"2011","N00001599 (Windsor ward)","N00001599",149,11,8,3,1,9,7,2,126,124,2,2
"2011","N00001600 (Windsor ward)","N00001600",134,36,15,21,0,7,6,1,88,78,10,3
"2011","N00001601 (Windsor ward)","N00001601",109,38,22,16,1,1,0,1,65,61,4,4
"2011","N00001602 (Windsor ward)","N00001602",145,48,30,18,0,8,3,5,83,79,4,6
"2011","N00001603 (Windsor ward)","N00001603",158,18,8,10,0,73,1,72,62,61,1,5
"2011","N00001604 (Woodstock ward)","N00001604",146,56,18,38,1,35,35,0,52,45,7,2
"2011","N00001605 (Woodstock ward)","N00001605",138,69,28,41,1,35,30,5,29,28,1,4
"2011","N00001606 (Woodstock ward)","N00001606",104,50,19,31,0,10,6,4,43,39,4,1
"2011","N00001607 (Woodstock ward)","N00001607",132,57,16,41,1,34,22,12,40,37,3,0
"2011","N00001608 (Woodstock ward)","N00001608",123,56,22,34,0,24,24,0,37,36,1,6
"2011","N00001609 (Woodstock ward)","N00001609",121,58,14,44,1,8,2,6,53,52,1,1
"2011","N00001610 (Woodstock ward)","N00001610",125,34,11,23,1,50,7,43,39,37,2,1
"2011","N00001611 (Woodstock ward)","N00001611",138,29,4,25,0,87,79,8,15,15,0,7
"2011","N00001612 (Woodstock ward)","N00001612",130,19,3,16,1,100,80,20,8,8,0,2
"2011","N00001613 (Woodstock ward)","N00001613",301,69,28,41,2,128,114,14,89,87,2,13
"2011","N00001614 (Woodstock ward)","N00001614",132,30,11,19,1,52,45,7,41,39,2,8
"2011","N00001615 (Woodstock ward)","N00001615",146,73,42,31,1,27,8,19,42,40,2,3
"2011","N00001616 (Woodstock ward)","N00001616",146,39,23,16,0,60,7,53,44,43,1,3
"2011","N00001617 (Woodstock ward)","N00001617",133,55,26,29,1,13,7,6,62,57,5,2
"2011","N00001618 (Woodstock ward)","N00001618",119,41,16,25,0,41,36,5,32,32,0,5
"2011","N00001619 (Woodstock ward)","N00001619",160,46,25,21,1,78,26,52,24,22,2,11
"2011","N00001620 (Woodstock ward)","N00001620",138,39,20,19,0,54,15,39,42,40,2,3
"2011","N00001621 (Woodstock ward)","N00001621",115,39,14,25,0,47,5,42,26,22,4,3
"2011","N00001622 (Woodstock ward)","N00001622",106,32,12,20,1,38,5,33,34,30,4,1
"2011","N00001623 (Woodvale ward)","N00001623",132,49,30,19,1,40,21,19,36,36,0,6
"2011","N00001624 (Woodvale ward)","N00001624",94,40,30,10,0,9,7,2,45,44,1,0
"2011","N00001625 (Woodvale ward)","N00001625",125,65,29,36,0,14,9,5,43,40,3,3
"2011","N00001626 (Woodvale ward)","N00001626",122,63,41,22,2,13,6,7,44,43,1,0
"2011","N00001627 (Woodvale ward)","N00001627",91,25,17,8,0,41,9,32,19,12,7,6
"2011","N00001628 (Woodvale ward)","N00001628",119,51,34,17,1,42,17,25,23,19,4,2
"2011","N00001629 (Woodvale ward)","N00001629",155,71,46,25,0,61,21,40,16,15,1,7
"2011","N00001630 (Woodvale ward)","N00001630",107,26,17,9,0,39,8,31,38,36,2,4
"2011","N00001631 (Woodvale ward)","N00001631",108,24,12,12,0,57,23,34,23,23,0,4
"2011","N00001632 (Woodvale ward)","N00001632",118,29,11,18,0,65,54,11,8,6,2,16
"2011","N00001633 (Woodvale ward)","N00001633",100,47,25,22,0,20,4,16,32,31,1,1
"2011","N00001634 (Woodvale ward)","N00001634",122,45,31,14,0,35,10,25,42,41,1,0
"2011","N00001635 (Woodvale ward)","N00001635",145,75,41,34,0,52,39,13,11,11,0,7
"2011","N00001636 (Woodvale ward)","N00001636",84,15,7,8,0,59,36,23,6,5,1,4
"2011","N00001637 (Woodvale ward)","N00001637",112,17,9,8,1,81,63,18,8,7,1,5
"2011","N00001638 (Woodvale ward)","N00001638",132,31,15,16,0,77,38,39,19,17,2,5
"2011","N00001639 (Woodvale ward)","N00001639",104,6,1,5,1,83,7,76,8,7,1,6
"2011","N00001640 (Woodvale ward)","N00001640",111,16,11,5,0,75,32,43,10,10,0,10
"2011","N00001759 (Ballyhanwood ward)","N00001759",121,112,67,45,0,0,0,0,7,6,1,2
"2011","N00001762 (Beechill ward)","N00001762",133,70,36,34,1,43,36,7,14,12,2,5
"2011","N00001764 (Beechill ward)","N00001764",128,40,22,18,0,72,72,0,10,7,3,6
"2011","N00001765 (Beechill ward)","N00001765",470,237,112,125,1,198,193,5,24,21,3,10
"2011","N00001766 (Beechill ward)","N00001766",128,91,46,45,2,23,15,8,10,8,2,2
"2011","N00001806 (Cregagh ward)","N00001806",128,72,24,48,3,31,31,0,16,10,6,6
"2011","N00001807 (Cregagh ward)","N00001807",110,73,30,43,2,17,15,2,17,15,2,1
"2011","N00001808 (Cregagh ward)","N00001808",107,68,29,39,2,27,26,1,9,7,2,1
"2011","N00001809 (Cregagh ward)","N00001809",111,60,31,29,1,38,38,0,5,2,3,7
"2011","N00001810 (Cregagh ward)","N00001810",120,43,22,21,0,54,52,2,14,12,2,9
"2011","N00001811 (Cregagh ward)","N00001811",102,55,17,38,2,33,32,1,11,6,5,1
"2011","N00001812 (Cregagh ward)","N00001812",213,57,29,28,0,131,121,10,15,14,1,10
"2011","N00001813 (Cregagh ward)","N00001813",100,19,8,11,1,72,15,57,3,3,0,5
"2011","N00001814 (Downshire ward)","N00001814",352,206,96,110,6,97,96,1,36,30,6,7
"2011","N00001815 (Downshire ward)","N00001815",128,111,53,58,2,2,2,0,13,12,1,0
"2011","N00001816 (Downshire ward)","N00001816",235,150,67,83,3,55,36,19,23,20,3,4
"2011","N00001817 (Downshire ward)","N00001817",112,99,53,46,1,1,1,0,9,8,1,2
"2011","N00001818 (Downshire ward)","N00001818",109,96,53,43,0,6,6,0,7,6,1,0
"2011","N00001819 (Downshire ward)","N00001819",137,118,60,58,0,5,5,0,13,13,0,1
"2011","N00001847 (Gilnahirk ward)","N00001847",120,117,74,43,0,1,1,0,1,1,0,1
"2011","N00001848 (Gilnahirk ward)","N00001848",118,109,51,58,0,2,2,0,6,6,0,1
"2011","N00001849 (Gilnahirk ward)","N00001849",125,109,53,56,4,2,2,0,7,6,1,3
"2011","N00001850 (Gilnahirk ward)","N00001850",261,231,104,127,0,3,3,0,22,21,1,5
"2011","N00001851 (Gilnahirk ward)","N00001851",116,113,60,53,0,0,0,0,3,3,0,0
"2011","N00001852 (Gilnahirk ward)","N00001852",125,117,66,51,0,2,0,2,5,5,0,1
"2011","N00001853 (Gilnahirk ward)","N00001853",142,128,64,64,0,1,1,0,13,12,1,0
"2011","N00001864 (Hillfoot ward)","N00001864",142,130,74,56,0,1,1,0,11,10,1,0
"2011","N00001865 (Hillfoot ward)","N00001865",243,229,147,82,1,0,0,0,12,9,3,1
"2011","N00001866 (Hillfoot ward)","N00001866",114,104,60,44,0,0,0,0,8,7,1,2
"2011","N00001867 (Hillfoot ward)","N00001867",147,131,61,70,1,1,1,0,13,12,1,1
"2011","N00001868 (Hillfoot ward)","N00001868",132,123,56,67,0,0,0,0,7,7,0,2
"2011","N00001869 (Hillfoot ward)","N00001869",121,107,64,43,0,0,0,0,14,13,1,0
"2011","N00001870 (Hillfoot ward)","N00001870",127,113,55,58,0,0,0,0,13,13,0,1
"2011","N00001880 (Lisnasharragh ward)","N00001880",118,107,54,53,0,6,6,0,5,3,2,0
"2011","N00001881 (Lisnasharragh ward)","N00001881",414,253,120,133,5,114,81,33,35,25,10,7
"2011","N00001882 (Lisnasharragh ward)","N00001882",117,111,69,42,1,3,2,1,2,2,0,0
"2011","N00001883 (Lisnasharragh ward)","N00001883",116,69,24,45,1,34,34,0,7,5,2,5
"2011","N00001884 (Lisnasharragh ward)","N00001884",125,113,79,34,0,1,1,0,9,8,1,2
"2011","N00001885 (Lower Braniel ward)","N00001885",129,45,23,22,2,63,57,6,8,8,0,11
"2011","N00001886 (Lower Braniel ward)","N00001886",139,36,14,22,0,90,84,6,5,4,1,8
"2011","N00001887 (Lower Braniel ward)","N00001887",133,76,27,49,0,43,43,0,13,9,4,1
"2011","N00001888 (Lower Braniel ward)","N00001888",141,103,60,43,0,32,7,25,4,3,1,2
"2011","N00001889 (Lower Braniel ward)","N00001889",108,51,14,37,2,42,40,2,8,6,2,5
"2011","N00001890 (Lower Braniel ward)","N00001890",254,208,104,104,0,14,14,0,27,25,2,5
"2011","N00001891 (Lower Braniel ward)","N00001891",156,134,64,70,0,5,5,0,14,11,3,3
"2011","N00001892 (Lower Braniel ward)","N00001892",130,120,72,48,2,1,1,0,6,4,2,1
"2011","N00001893 (Minnowburn ward)","N00001893",117,72,34,38,2,37,37,0,6,6,0,0
"2011","N00001894 (Minnowburn ward)","N00001894",155,90,44,46,0,53,25,28,9,6,3,3
"2011","N00001895 (Minnowburn ward)","N00001895",157,85,36,49,1,50,49,1,15,11,4,6
"2011","N00001896 (Minnowburn ward)","N00001896",279,140,62,78,0,86,86,0,36,31,5,17
"2011","N00001897 (Minnowburn ward)","N00001897",128,82,34,48,1,37,37,0,5,5,0,3
"2011","N00001898 (Minnowburn ward)","N00001898",128,89,39,50,2,22,22,0,14,13,1,1
"2011","N00001899 (Minnowburn ward)","N00001899",126,37,17,20,2,76,75,1,6,6,0,5
"2011","N00001912 (Newtownbreda ward)","N00001912",199,115,66,49,0,43,12,31,36,29,7,5
"2011","N00001919 (Tullycarnet ward)","N00001919",126,59,18,41,2,56,56,0,5,5,0,4
"2011","N00001920 (Tullycarnet ward)","N00001920",136,123,70,53,0,2,2,0,9,9,0,2
"2011","N00001921 (Tullycarnet ward)","N00001921",115,61,29,32,6,31,30,1,13,11,2,4
"2011","N00001922 (Tullycarnet ward)","N00001922",135,84,42,42,0,40,39,1,5,5,0,6
"2011","N00001923 (Tullycarnet ward)","N00001923",135,31,13,18,1,94,94,0,3,3,0,6
"2011","N00001924 (Tullycarnet ward)","N00001924",142,57,7,50,5,50,50,0,26,26,0,4
"2011","N00001925 (Tullycarnet ward)","N00001925",118,60,29,31,1,47,47,0,7,6,1,3
"2011","N00001926 (Tullycarnet ward)","N00001926",138,69,29,40,0,54,54,0,7,3,4,8
"2011","N00001927 (Upper Braniel ward)","N00001927",104,67,27,40,2,21,21,0,10,9,1,4
"2011","N00001928 (Upper Braniel ward)","N00001928",120,78,44,34,1,31,31,0,7,7,0,3
"2011","N00001929 (Upper Braniel ward)","N00001929",180,166,86,80,0,1,1,0,13,11,2,0
"2011","N00001930 (Upper Braniel ward)","N00001930",109,70,32,38,2,26,26,0,7,6,1,4
"2011","N00001931 (Upper Braniel ward)","N00001931",112,83,46,37,4,14,14,0,9,9,0,2
"2011","N00001932 (Upper Braniel ward)","N00001932",117,108,67,41,2,2,2,0,4,3,1,1
"2011","N00001933 (Upper Braniel ward)","N00001933",123,115,59,56,0,0,0,0,8,6,2,0
"2011","N00001934 (Upper Braniel ward)","N00001934",125,82,40,42,2,29,29,0,6,5,1,6
"2011","N00001935 (Wynchurch ward)","N00001935",128,114,52,62,0,0,0,0,12,11,1,2
"2011","N00001936 (Wynchurch ward)","N00001936",123,107,56,51,1,1,1,0,11,10,1,3
"2011","N00001937 (Wynchurch ward)","N00001937",126,110,69,41,0,0,0,0,13,9,4,3
"2011","N00001938 (Wynchurch ward)","N00001938",133,71,31,40,2,45,44,1,11,11,0,4
"2011","N00001939 (Wynchurch ward)","N00001939",130,88,35,53,2,21,21,0,14,10,4,5
"2011","N00001940 (Wynchurch ward)","N00001940",144,121,56,65,0,2,2,0,20,17,3,1
"2011","N00001941 (Wynchurch ward)","N00001941",126,112,61,51,0,3,1,2,10,10,0,1
"2011","N00003294 (Collin Glen ward)","N00003294",115,38,7,31,0,68,48,20,4,3,1,5
"2011","N00003295 (Collin Glen ward)","N00003295",274,93,5,88,3,151,102,49,15,15,0,12
"2011","N00003296 (Collin Glen ward)","N00003296",133,36,4,32,0,79,68,11,14,14,0,4
"2011","N00003297 (Collin Glen ward)","N00003297",128,39,3,36,0,77,67,10,8,5,3,4
"2011","N00003298 (Collin Glen ward)","N00003298",202,51,2,49,0,137,77,60,9,7,2,5
"2011","N00003299 (Collin Glen ward)","N00003299",205,44,2,42,0,142,84,58,11,7,4,8
"2011","N00003300 (Collin Glen ward)","N00003300",105,18,3,15,0,77,36,41,7,6,1,3
"2011","N00003301 (Collin Glen ward)","N00003301",111,64,16,48,0,40,40,0,5,5,0,2
"2011","N00003302 (Collin Glen ward)","N00003302",155,55,7,48,0,93,79,14,3,2,1,4
"2011","N00003303 (Collin Glen ward)","N00003303",122,41,3,38,3,61,54,7,7,7,0,10
"2011","N00003304 (Collin Glen ward)","N00003304",116,47,5,42,0,63,54,9,3,3,0,3
"2011","N00003305 (Collin Glen ward)","N00003305",160,43,7,36,0,108,91,17,4,3,1,5
"2011","N00003306 (Derryaghy ward)","N00003306",193,129,13,116,0,56,7,49,8,8,0,0
"2011","N00003308 (Derryaghy ward)","N00003308",988,684,53,631,18,203,46,157,72,66,6,11
"2011","N00003311 (Derryaghy ward)","N00003311",393,328,22,306,11,27,12,15,26,25,1,1
"2011","N00003312 (Derryaghy ward)","N00003312",134,125,19,106,3,2,2,0,4,4,0,0
"2011","N00003328 (Drumbo ward)","N00003328",117,81,33,48,0,1,1,0,33,30,3,2
"2011","N00003329 (Drumbo ward)","N00003329",139,122,69,53,0,2,0,2,12,11,1,3
"2011","N00003337 (Dunmurry ward)","N00003337",144,95,26,69,2,3,3,0,41,38,3,3
"2011","N00003338 (Dunmurry ward)","N00003338",115,84,20,64,3,7,1,6,20,19,1,1
"2011","N00003339 (Dunmurry ward)","N00003339",186,116,51,65,2,15,4,11,49,48,1,4
"2011","N00003340 (Dunmurry ward)","N00003340",132,59,14,45,0,58,11,47,11,11,0,4
"2011","N00003341 (Dunmurry ward)","N00003341",113,80,25,55,0,26,25,1,3,3,0,4
"2011","N00003342 (Dunmurry ward)","N00003342",129,114,44,70,1,6,6,0,8,8,0,0
"2011","N00003343 (Dunmurry ward)","N00003343",126,72,17,55,1,36,33,3,12,12,0,5
"2011","N00003344 (Dunmurry ward)","N00003344",139,110,61,49,0,0,0,0,27,23,4,2
"2011","N00003345 (Dunmurry ward)","N00003345",99,99,20,79,0,0,0,0,0,0,0,0
"2011","N00003346 (Dunmurry ward)","N00003346",127,124,25,99,0,0,0,0,2,2,0,1
"2011","N00003347 (Dunmurry ward)","N00003347",137,129,36,93,0,1,1,0,7,5,2,0
"2011","N00003348 (Dunmurry ward)","N00003348",160,144,59,85,0,4,4,0,10,8,2,2
"2011","N00003397 (Kilwee ward)","N00003397",109,55,14,41,0,49,3,46,5,3,2,0
"2011","N00003398 (Kilwee ward)","N00003398",119,110,34,76,3,0,0,0,6,6,0,0
"2011","N00003399 (Kilwee ward)","N00003399",129,115,44,71,0,2,0,2,12,11,1,0
"2011","N00003400 (Kilwee ward)","N00003400",139,124,42,82,2,2,1,1,7,6,1,4
"2011","N00003401 (Kilwee ward)","N00003401",121,115,41,74,0,2,2,0,3,2,1,1
"2011","N00003402 (Kilwee ward)","N00003402",144,67,15,52,0,74,59,15,1,1,0,2
"2011","N00003403 (Kilwee ward)","N00003403",114,29,3,26,0,75,75,0,6,6,0,4
"2011","N00003404 (Kilwee ward)","N00003404",133,47,19,28,0,74,43,31,5,4,1,7
"2011","N00003405 (Kilwee ward)","N00003405",144,71,21,50,1,59,44,15,7,5,2,6
"2011","N00003490 (Poleglass ward)","N00003490",97,30,4,26,0,65,9,56,1,0,1,1
"2011","N00003491 (Poleglass ward)","N00003491",249,85,14,71,2,140,65,75,13,13,0,9
"2011","N00003492 (Poleglass ward)","N00003492",117,68,8,60,3,42,38,4,2,2,0,2
"2011","N00003493 (Poleglass ward)","N00003493",245,114,13,101,2,112,108,4,12,10,2,5
"2011","N00003494 (Poleglass ward)","N00003494",261,216,86,130,10,16,3,13,18,16,2,1
"2011","N00003495 (Poleglass ward)","N00003495",138,130,68,62,0,5,3,2,2,1,1,1
"2011","N00003496 (Poleglass ward)","N00003496",207,127,19,108,8,52,5,47,15,12,3,5
"2011","N00003500 (Seymour Hill ward)","N00003500",130,110,55,55,0,2,2,0,16,15,1,2
"2011","N00003501 (Seymour Hill ward)","N00003501",122,82,36,46,3,14,14,0,20,19,1,3
"2011","N00003503 (Seymour Hill ward)","N00003503",143,77,32,45,1,41,41,0,20,18,2,4
"2011","N00003504 (Seymour Hill ward)","N00003504",128,117,68,49,0,1,0,1,10,10,0,0
"2011","N00003514 (Twinbrook ward)","N00003514",241,118,24,94,1,105,89,16,11,8,3,6
"2011","N00003515 (Twinbrook ward)","N00003515",92,62,21,41,0,27,27,0,2,0,2,1
"2011","N00003516 (Twinbrook ward)","N00003516",126,55,6,49,1,60,49,11,5,5,0,5
"2011","N00003517 (Twinbrook ward)","N00003517",246,123,41,82,2,93,87,6,12,11,1,16
"2011","N00003518 (Twinbrook ward)","N00003518",116,60,22,38,1,47,45,2,5,5,0,3
"2011","N00003519 (Twinbrook ward)","N00003519",87,43,20,23,0,38,36,2,4,4,0,2
"2011","N00003520 (Twinbrook ward)","N00003520",123,80,16,64,1,31,30,1,9,7,2,2
"2011","N00004291 (Loughview ward)","N00004291",164,135,45,90,7,5,4,1,15,13,2,2
"2011","N00000643 (Ballyhoe and Corkey ward)","N00000643",148,125,64,61,0,9,9,0,11,8,3,3
"2011","N00000644 (Ballyhoe and Corkey ward)","N00000644",184,123,46,77,0,35,35,0,22,19,3,4
"2011","N00000645 (Ballyhoe and Corkey ward)","N00000645",136,111,64,47,2,6,6,0,14,11,3,3
"2011","N00000646 (Ballyhoe and Corkey ward)","N00000646",124,97,41,56,0,16,16,0,9,7,2,2
"2011","N00000647 (Benvardin ward)","N00000647",300,151,83,68,2,91,90,1,45,37,8,11
"2011","N00000648 (Benvardin ward)","N00000648",129,100,57,43,1,10,10,0,14,14,0,4
"2011","N00000649 (Benvardin ward)","N00000649",132,113,72,41,0,5,5,0,11,8,3,3
"2011","N00000650 (Benvardin ward)","N00000650",229,177,64,113,1,19,19,0,29,27,2,3
"2011","N00000651 (Carnany ward)","N00000651",122,17,7,10,0,94,94,0,6,6,0,5
"2011","N00000652 (Carnany ward)","N00000652",200,156,58,98,3,5,5,0,36,36,0,0
"2011","N00000653 (Carnany ward)","N00000653",116,101,47,54,1,3,3,0,8,7,1,3
"2011","N00000654 (Carnany ward)","N00000654",114,53,25,28,1,49,49,0,8,8,0,3
"2011","N00000655 (Carnany ward)","N00000655",141,107,53,54,3,6,3,3,25,22,3,0
"2011","N00000656 (Carnany ward)","N00000656",115,48,34,14,0,56,56,0,4,2,2,7
"2011","N00000657 (Clogh Mills ward)","N00000657",318,240,90,150,3,19,19,0,50,43,7,6
"2011","N00000658 (Clogh Mills ward)","N00000658",123,109,66,43,0,1,1,0,10,8,2,3
"2011","N00000659 (Clogh Mills ward)","N00000659",142,108,49,59,0,5,5,0,22,21,1,7
"2011","N00000660 (Clogh Mills ward)","N00000660",153,92,37,55,0,39,39,0,15,13,2,7
"2011","N00000661 (Dervock ward)","N00000661",141,115,73,42,1,6,6,0,11,9,2,8
"2011","N00000662 (Dervock ward)","N00000662",140,119,67,52,0,9,9,0,8,8,0,4
"2011","N00000663 (Dervock ward)","N00000663",148,115,76,39,0,4,4,0,24,18,6,5
"2011","N00000664 (Dervock ward)","N00000664",148,93,58,35,0,15,15,0,27,24,3,13
"2011","N00000665 (Dunloy ward)","N00000665",145,114,61,53,0,14,11,3,14,10,4,3
"2011","N00000666 (Dunloy ward)","N00000666",132,117,64,53,0,4,4,0,8,7,1,3
"2011","N00000667 (Dunloy ward)","N00000667",137,120,48,72,1,4,4,0,11,11,0,1
"2011","N00000668 (Dunloy ward)","N00000668",127,62,38,24,0,42,41,1,17,14,3,6
"2011","N00000669 (Dunloy ward)","N00000669",151,116,44,72,0,8,8,0,24,24,0,3
"2011","N00000670 (Fairhill ward)","N00000670",126,87,42,45,0,17,17,0,19,15,4,3
"2011","N00000671 (Fairhill ward)","N00000671",130,81,49,32,0,24,24,0,15,12,3,10
"2011","N00000672 (Fairhill ward)","N00000672",131,106,54,52,0,8,8,0,13,10,3,4
"2011","N00000673 (Fairhill ward)","N00000673",353,218,90,128,2,34,34,0,95,89,6,4
"2011","N00000674 (Glebe ward)","N00000674",130,113,79,34,0,0,0,0,13,12,1,4
"2011","N00000675 (Glebe ward)","N00000675",144,130,79,51,0,0,0,0,11,10,1,3
"2011","N00000676 (Glebe ward)","N00000676",294,209,112,97,2,10,10,0,60,56,4,13
"2011","N00000677 (Glebe ward)","N00000677",143,60,33,27,4,12,12,0,63,61,2,4
"2011","N00000678 (Killoquin Lower ward)","N00000678",161,134,72,62,0,7,6,1,16,15,1,4
"2011","N00000679 (Killoquin Lower ward)","N00000679",167,139,76,63,0,7,7,0,17,15,2,4
"2011","N00000680 (Killoquin Lower ward)","N00000680",139,81,43,38,0,38,38,0,15,11,4,5
"2011","N00000681 (Killoquin Lower ward)","N00000681",138,111,63,48,0,13,12,1,9,9,0,5
"2011","N00000682 (Killoquin Upper ward)","N00000682",143,127,77,50,1,3,3,0,7,6,1,5
"2011","N00000683 (Killoquin Upper ward)","N00000683",132,105,71,34,0,4,4,0,11,7,4,12
"2011","N00000684 (Killoquin Upper ward)","N00000684",202,138,71,67,3,8,7,1,50,47,3,3
"2011","N00000685 (Killoquin Upper ward)","N00000685",121,58,20,38,2,35,35,0,17,15,2,9
"2011","N00000686 (Knockaholet ward)","N00000686",148,136,79,57,0,1,1,0,8,6,2,3
"2011","N00000687 (Knockaholet ward)","N00000687",135,102,60,42,1,22,22,0,10,7,3,0
"2011","N00000688 (Knockaholet ward)","N00000688",132,106,65,41,0,3,3,0,21,16,5,2
"2011","N00000689 (Knockaholet ward)","N00000689",136,117,76,41,0,4,4,0,13,9,4,2
"2011","N00000690 (Newhill ward)","N00000690",119,65,15,50,0,20,20,0,31,29,2,3
"2011","N00000691 (Newhill ward)","N00000691",129,43,10,33,2,69,68,1,12,11,1,3
"2011","N00000692 (Newhill ward)","N00000692",129,42,18,24,0,72,72,0,7,5,2,8
"2011","N00000693 (Newhill ward)","N00000693",125,75,39,36,1,27,27,0,15,13,2,7
"2011","N00000694 (Newhill ward)","N00000694",356,176,55,121,3,49,29,20,114,105,9,14
"2011","N00000695 (Newhill ward)","N00000695",201,146,46,100,6,4,3,1,43,39,4,2
"2011","N00000696 (Route ward)","N00000696",114,29,20,9,0,39,2,37,41,38,3,5
"2011","N00000697 (Route ward)","N00000697",149,123,75,48,0,6,6,0,19,16,3,1
"2011","N00000698 (Route ward)","N00000698",187,120,75,45,2,21,21,0,39,38,1,5
"2011","N00000699 (Route ward)","N00000699",148,44,32,12,1,67,29,38,32,29,3,4
"2011","N00000700 (Route ward)","N00000700",120,50,30,20,0,48,48,0,18,14,4,4
"2011","N00000701 (Seacon ward)","N00000701",94,41,24,17,0,40,40,0,10,10,0,3
"2011","N00000702 (Seacon ward)","N00000702",311,215,85,130,4,1,1,0,87,81,6,4
"2011","N00000703 (Seacon ward)","N00000703",131,97,54,43,4,16,16,0,6,5,1,8
"2011","N00000704 (Seacon ward)","N00000704",238,189,92,97,2,23,23,0,20,19,1,4
"2011","N00000705 (Seacon ward)","N00000705",242,194,71,123,2,3,3,0,43,40,3,0
"2011","N00000706 (Stranocum ward)","N00000706",154,106,63,43,2,33,33,0,10,9,1,3
"2011","N00000707 (Stranocum ward)","N00000707",132,99,50,49,0,21,21,0,9,8,1,3
"2011","N00000708 (Stranocum ward)","N00000708",155,132,75,57,0,7,7,0,11,8,3,5
"2011","N00000709 (Stranocum ward)","N00000709",165,138,68,70,1,2,2,0,16,14,2,8
"2011","N00000710 (The Vow ward)","N00000710",117,100,53,47,0,3,3,0,11,10,1,3
"2011","N00000711 (The Vow ward)","N00000711",195,137,41,96,2,11,11,0,41,40,1,4
"2011","N00000712 (The Vow ward)","N00000712",134,105,66,39,0,20,20,0,6,6,0,3
"2011","N00000713 (The Vow ward)","N00000713",135,120,69,51,0,7,7,0,6,4,2,2
"2011","N00000714 (The Vow ward)","N00000714",128,111,64,47,0,4,4,0,8,8,0,5
"2011","N00001942 (Agivey ward)","N00001942",158,133,76,57,1,4,4,0,15,13,2,5
"2011","N00001943 (Agivey ward)","N00001943",155,134,84,50,0,2,2,0,13,12,1,6
"2011","N00001944 (Agivey ward)","N00001944",130,102,55,47,0,22,22,0,4,3,1,2
"2011","N00001945 (Agivey ward)","N00001945",152,136,80,56,0,2,2,0,13,12,1,1
"2011","N00001946 (Agivey ward)","N00001946",132,104,64,40,1,12,12,0,11,3,8,4
"2011","N00001947 (Agivey ward)","N00001947",165,143,78,65,1,3,2,1,14,13,1,4
"2011","N00001948 (Atlantic ward)","N00001948",87,19,7,12,1,57,56,1,9,8,1,1
"2011","N00001949 (Atlantic ward)","N00001949",296,218,137,81,0,23,7,16,53,47,6,2
"2011","N00001950 (Atlantic ward)","N00001950",114,38,16,22,1,50,50,0,16,15,1,9
"2011","N00001951 (Atlantic ward)","N00001951",104,88,56,32,1,1,1,0,12,10,2,2
"2011","N00001952 (Atlantic ward)","N00001952",125,92,64,28,0,8,5,3,24,21,3,1
"2011","N00001953 (Atlantic ward)","N00001953",111,49,23,26,0,47,47,0,12,11,1,3
"2011","N00001954 (Atlantic ward)","N00001954",99,93,66,27,0,2,2,0,1,1,0,3
"2011","N00001955 (Atlantic ward)","N00001955",138,95,65,30,0,1,1,0,39,38,1,3
"2011","N00001956 (Ballysally ward)","N00001956",90,12,5,7,0,72,71,1,2,2,0,4
"2011","N00001957 (Ballysally ward)","N00001957",113,69,35,34,4,27,27,0,11,10,1,2
"2011","N00001958 (Ballysally ward)","N00001958",136,30,11,19,0,95,95,0,6,6,0,5
"2011","N00001959 (Ballysally ward)","N00001959",119,30,13,17,0,82,82,0,3,3,0,4
"2011","N00001960 (Ballysally ward)","N00001960",138,23,8,15,0,103,102,1,4,4,0,8
"2011","N00001961 (Ballysally ward)","N00001961",146,115,30,85,4,4,3,1,21,19,2,2
"2011","N00001962 (Ballysally ward)","N00001962",88,63,28,35,4,1,1,0,19,16,3,1
"2011","N00001963 (Ballysally ward)","N00001963",73,11,3,8,0,54,54,0,5,5,0,3
"2011","N00001964 (Ballysally ward)","N00001964",120,32,10,22,1,78,71,7,7,7,0,2
"2011","N00001965 (Castlerock ward)","N00001965",129,106,64,42,0,3,3,0,15,13,2,5
"2011","N00001966 (Castlerock ward)","N00001966",163,131,72,59,2,2,2,0,25,22,3,3
"2011","N00001967 (Castlerock ward)","N00001967",168,134,69,65,1,7,7,0,23,19,4,3
"2011","N00001968 (Castlerock ward)","N00001968",150,60,27,33,1,65,63,2,17,15,2,7
"2011","N00001969 (Castlerock ward)","N00001969",240,176,116,60,1,1,1,0,51,47,4,11
"2011","N00001970 (Castlerock ward)","N00001970",123,69,39,30,2,31,31,0,16,15,1,5
"2011","N00001971 (Castlerock ward)","N00001971",165,129,58,71,2,4,4,0,26,18,8,4
"2011","N00001972 (Castlerock ward)","N00001972",141,114,78,36,0,3,3,0,20,18,2,4
"2011","N00001973 (Central ward)","N00001973",188,48,35,13,2,63,40,23,68,67,1,7
"2011","N00001974 (Central ward)","N00001974",101,41,23,18,2,7,6,1,46,45,1,5
"2011","N00001975 (Central ward)","N00001975",138,58,40,18,0,19,13,6,55,49,6,6
"2011","N00001976 (Central ward)","N00001976",223,84,44,40,4,64,20,44,62,50,12,9
"2011","N00001977 (Central ward)","N00001977",108,60,28,32,1,1,1,0,44,41,3,2
"2011","N00001978 (Central ward)","N00001978",134,77,42,35,3,18,16,2,30,25,5,6
"2011","N00001979 (Churchland ward)","N00001979",124,56,30,26,1,39,37,2,23,18,5,5
"2011","N00001980 (Churchland ward)","N00001980",120,25,13,12,1,78,78,0,8,8,0,8
"2011","N00001981 (Churchland ward)","N00001981",136,25,13,12,2,67,25,42,30,26,4,12
"2011","N00001982 (Churchland ward)","N00001982",305,175,49,126,10,65,47,18,48,35,13,7
"2011","N00001983 (Churchland ward)","N00001983",127,47,26,21,2,56,54,2,16,16,0,6
"2011","N00001984 (Churchland ward)","N00001984",133,88,40,48,2,19,14,5,20,20,0,4
"2011","N00001985 (Churchland ward)","N00001985",118,32,13,19,0,63,61,2,17,15,2,6
"2011","N00001986 (Cross Glebe ward)","N00001986",175,71,33,38,1,49,34,15,48,43,5,6
"2011","N00001987 (Cross Glebe ward)","N00001987",151,70,19,51,0,41,41,0,36,36,0,4
"2011","N00001988 (Cross Glebe ward)","N00001988",143,74,34,40,1,43,43,0,19,16,3,6
"2011","N00001989 (Cross Glebe ward)","N00001989",129,101,32,69,2,8,7,1,17,16,1,1
"2011","N00001990 (Cross Glebe ward)","N00001990",110,29,9,20,2,61,60,1,11,10,1,7
"2011","N00001991 (Cross Glebe ward)","N00001991",135,40,9,31,2,74,74,0,14,13,1,5
"2011","N00001992 (Cross Glebe ward)","N00001992",132,36,15,21,1,65,64,1,24,16,8,6
"2011","N00001993 (Cross Glebe ward)","N00001993",117,38,11,27,0,67,51,16,5,5,0,7
"2011","N00001994 (Dundooan ward)","N00001994",131,107,65,42,0,11,10,1,10,9,1,3
"2011","N00001995 (Dundooan ward)","N00001995",138,107,63,44,0,13,12,1,7,4,3,11
"2011","N00001996 (Dundooan ward)","N00001996",126,86,51,35,0,26,26,0,10,10,0,4
"2011","N00001997 (Dundooan ward)","N00001997",145,121,84,37,0,4,4,0,13,13,0,7
"2011","N00001998 (Dundooan ward)","N00001998",110,63,29,34,6,0,0,0,38,36,2,3
"2011","N00001999 (Dundooan ward)","N00001999",409,244,108,136,1,12,3,9,146,142,4,6
"2011","N00002000 (Dundooan ward)","N00002000",128,115,72,43,0,0,0,0,13,9,4,0
"2011","N00002001 (Dunluce ward)","N00002001",137,122,79,43,0,1,1,0,8,6,2,6
"2011","N00002002 (Dunluce ward)","N00002002",116,100,74,26,0,9,9,0,6,5,1,1
"2011","N00002003 (Dunluce ward)","N00002003",113,94,59,35,0,8,7,1,8,8,0,3
"2011","N00002004 (Dunluce ward)","N00002004",144,121,76,45,0,8,8,0,12,12,0,3
"2011","N00002005 (Dunluce ward)","N00002005",97,83,68,15,0,4,4,0,10,8,2,0
"2011","N00002006 (Dunluce ward)","N00002006",119,89,63,26,0,16,13,3,10,7,3,4
"2011","N00002007 (Dunluce ward)","N00002007",113,103,83,20,0,1,0,1,7,5,2,2
"2011","N00002008 (Garvagh ward)","N00002008",273,157,106,51,1,61,43,18,43,33,10,11
"2011","N00002009 (Garvagh ward)","N00002009",135,64,40,24,1,29,29,0,33,29,4,8
"2011","N00002010 (Garvagh ward)","N00002010",155,128,72,56,0,3,1,2,17,16,1,7
"2011","N00002011 (Garvagh ward)","N00002011",177,137,86,51,0,4,4,0,22,20,2,14
"2011","N00002012 (Garvagh ward)","N00002012",164,135,65,70,0,11,10,1,9,7,2,9
"2011","N00002013 (Garvagh ward)","N00002013",123,57,36,21,0,53,53,0,11,9,2,2
"2011","N00002014 (Hopefield ward)","N00002014",356,253,117,136,2,26,26,0,74,71,3,1
"2011","N00002015 (Hopefield ward)","N00002015",126,94,53,41,2,16,12,4,13,12,1,1
"2011","N00002016 (Hopefield ward)","N00002016",115,44,27,17,0,50,41,9,18,16,2,3
"2011","N00002017 (Hopefield ward)","N00002017",127,109,69,40,1,1,1,0,12,12,0,4
"2011","N00002018 (Hopefield ward)","N00002018",573,450,230,220,8,4,2,2,103,91,12,8
"2011","N00002019 (Hopefield ward)","N00002019",122,96,67,29,0,0,0,0,23,21,2,3
"2011","N00002020 (Hopefield ward)","N00002020",123,99,66,33,2,0,0,0,19,18,1,3
"2011","N00002021 (Kilrea ward)","N00002021",150,129,66,63,0,3,2,1,14,12,2,4
"2011","N00002022 (Kilrea ward)","N00002022",146,99,44,55,0,8,8,0,37,34,3,2
"2011","N00002023 (Kilrea ward)","N00002023",153,124,78,46,0,3,3,0,23,20,3,3
"2011","N00002024 (Kilrea ward)","N00002024",159,116,46,70,0,2,2,0,36,30,6,5
"2011","N00002025 (Kilrea ward)","N00002025",121,48,34,14,0,49,37,12,23,20,3,1
"2011","N00002026 (Kilrea ward)","N00002026",168,64,21,43,1,63,63,0,36,35,1,4
"2011","N00002027 (Kilrea ward)","N00002027",105,62,35,27,0,19,19,0,18,15,3,6
"2011","N00002028 (Knocklynn ward)","N00002028",430,310,104,206,2,6,6,0,102,96,6,10
"2011","N00002029 (Knocklynn ward)","N00002029",229,175,63,112,1,3,3,0,47,42,5,3
"2011","N00002030 (Knocklynn ward)","N00002030",120,64,27,37,0,49,49,0,7,6,1,0
"2011","N00002031 (Knocklynn ward)","N00002031",123,101,43,58,0,0,0,0,20,16,4,2
"2011","N00002032 (Knocklynn ward)","N00002032",194,157,83,74,4,0,0,0,29,29,0,4
"2011","N00002033 (Knocklynn ward)","N00002033",105,90,52,38,0,0,0,0,11,11,0,4
"2011","N00002034 (Knocklynn ward)","N00002034",120,111,68,43,1,0,0,0,7,6,1,1
"2011","N00002035 (Knocklynn ward)","N00002035",136,104,51,53,4,1,1,0,24,22,2,3
"2011","N00002036 (Macosquin ward)","N00002036",136,106,74,32,1,16,16,0,10,6,4,3
"2011","N00002037 (Macosquin ward)","N00002037",184,165,92,73,0,3,3,0,13,12,1,3
"2011","N00002038 (Macosquin ward)","N00002038",157,141,81,60,0,4,4,0,8,8,0,4
"2011","N00002039 (Macosquin ward)","N00002039",126,58,39,19,0,61,59,2,4,4,0,3
"2011","N00002040 (Macosquin ward)","N00002040",125,97,60,37,0,15,15,0,9,7,2,4
"2011","N00002041 (Macosquin ward)","N00002041",121,104,60,44,0,5,5,0,7,5,2,5
"2011","N00002042 (Mount Sandel ward)","N00002042",123,100,81,19,1,1,1,0,18,16,2,3
"2011","N00002043 (Mount Sandel ward)","N00002043",141,74,39,35,0,6,3,3,58,53,5,3
"2011","N00002044 (Mount Sandel ward)","N00002044",272,176,104,72,2,2,2,0,84,79,5,8
"2011","N00002045 (Mount Sandel ward)","N00002045",133,94,53,41,0,0,0,0,38,35,3,1
"2011","N00002046 (Mount Sandel ward)","N00002046",110,95,64,31,2,0,0,0,12,10,2,1
"2011","N00002047 (Portstewart ward)","N00002047",122,65,46,19,0,16,15,1,39,34,5,2
"2011","N00002048 (Portstewart ward)","N00002048",107,41,28,13,2,40,13,27,22,19,3,2
"2011","N00002049 (Portstewart ward)","N00002049",117,73,54,19,1,1,1,0,35,28,7,7
"2011","N00002050 (Portstewart ward)","N00002050",104,39,16,23,0,43,41,2,20,14,6,2
"2011","N00002051 (Portstewart ward)","N00002051",249,121,77,44,3,35,27,8,77,71,6,13
"2011","N00002052 (Portstewart ward)","N00002052",108,58,32,26,1,3,3,0,45,42,3,1
"2011","N00002053 (Portstewart ward)","N00002053",109,46,24,22,2,32,32,0,25,22,3,4
"2011","N00002054 (Ringsend ward)","N00002054",161,141,93,48,1,4,4,0,11,9,2,4
"2011","N00002055 (Ringsend ward)","N00002055",166,128,82,46,0,21,16,5,14,11,3,3
"2011","N00002056 (Ringsend ward)","N00002056",167,149,87,62,0,2,2,0,11,10,1,5
"2011","N00002057 (Ringsend ward)","N00002057",139,122,85,37,0,1,1,0,11,8,3,5
"2011","N00002058 (Ringsend ward)","N00002058",191,169,90,79,0,1,1,0,14,14,0,7
"2011","N00002059 (Royal Portrush ward)","N00002059",126,55,29,26,1,36,36,0,23,21,2,11
"2011","N00002060 (Royal Portrush ward)","N00002060",430,185,127,58,2,58,23,35,172,160,12,13
"2011","N00002061 (Royal Portrush ward)","N00002061",307,197,113,84,1,34,7,27,61,56,5,14
"2011","N00002062 (Royal Portrush ward)","N00002062",112,83,50,33,1,8,7,1,17,16,1,3
"2011","N00002063 (Strand ward)","N00002063",129,101,77,24,2,0,0,0,23,23,0,3
"2011","N00002064 (Strand ward)","N00002064",293,197,118,79,3,2,2,0,87,84,3,4
"2011","N00002065 (Strand ward)","N00002065",105,83,63,20,0,1,1,0,13,12,1,8
"2011","N00002066 (Strand ward)","N00002066",125,87,56,31,0,0,0,0,32,28,4,6
"2011","N00002067 (Strand ward)","N00002067",372,162,84,78,0,42,5,37,163,158,5,5
"2011","N00002068 (Strand ward)","N00002068",104,82,56,26,1,2,2,0,15,13,2,4
"2011","N00002069 (The Cuts ward)","N00002069",162,106,44,62,1,28,28,0,24,20,4,3
"2011","N00002070 (The Cuts ward)","N00002070",422,344,99,245,5,4,3,1,66,63,3,3
"2011","N00002071 (The Cuts ward)","N00002071",136,127,79,48,0,1,1,0,6,6,0,2
"2011","N00002072 (The Cuts ward)","N00002072",113,89,34,55,2,2,2,0,20,18,2,0
"2011","N00002073 (The Cuts ward)","N00002073",119,68,33,35,1,39,39,0,7,6,1,4
"2011","N00002074 (The Cuts ward)","N00002074",324,266,120,146,2,21,21,0,31,27,4,4
"2011","N00002075 (The Cuts ward)","N00002075",130,112,47,65,1,2,2,0,12,11,1,3
"2011","N00002076 (The Cuts ward)","N00002076",104,60,32,28,0,26,18,8,16,16,0,2
"2011","N00002077 (The Cuts ward)","N00002077",108,90,52,38,1,2,2,0,12,11,1,3
"2011","N00002078 (University ward)","N00002078",119,59,26,33,1,38,38,0,19,15,4,2
"2011","N00002079 (University ward)","N00002079",289,184,113,71,1,17,17,0,79,72,7,8
"2011","N00002080 (University ward)","N00002080",131,54,22,32,2,53,53,0,18,17,1,4
"2011","N00002081 (University ward)","N00002081",129,40,20,20,1,52,52,0,18,16,2,18
"2011","N00002082 (University ward)","N00002082",294,195,104,91,2,6,6,0,84,63,21,7
"2011","N00002083 (Waterside ward)","N00002083",130,116,79,37,1,0,0,0,9,8,1,4
"2011","N00002084 (Waterside ward)","N00002084",171,134,73,61,4,2,1,1,31,29,2,0
"2011","N00002085 (Waterside ward)","N00002085",208,176,72,104,0,1,0,1,30,28,2,1
"2011","N00002086 (Waterside ward)","N00002086",177,165,110,55,0,1,1,0,10,9,1,1
"2011","N00002087 (Waterside ward)","N00002087",123,46,30,16,1,34,6,28,39,36,3,3
"2011","N00002088 (Waterside ward)","N00002088",143,112,57,55,1,1,1,0,27,23,4,2
"2011","N00002089 (Waterside ward)","N00002089",136,134,79,55,1,0,0,0,1,1,0,0
"2011","N00003161 (Aghanloo ward)","N00003161",495,410,127,283,3,6,3,3,72,64,8,4
"2011","N00003162 (Aghanloo ward)","N00003162",358,188,46,142,4,74,8,66,89,78,11,3
"2011","N00003163 (Aghanloo ward)","N00003163",169,142,83,59,0,9,9,0,11,11,0,7
"2011","N00003164 (Aghanloo ward)","N00003164",181,151,72,79,1,1,1,0,22,18,4,6
"2011","N00003165 (Aghanloo ward)","N00003165",114,72,35,37,1,23,21,2,16,13,3,2
"2011","N00003166 (Aghanloo ward)","N00003166",185,152,85,67,0,3,3,0,28,25,3,2
"2011","N00003167 (Ballykelly ward)","N00003167",106,94,64,30,0,0,0,0,11,9,2,1
"2011","N00003168 (Ballykelly ward)","N00003168",138,100,47,53,5,9,9,0,18,13,5,6
"2011","N00003169 (Ballykelly ward)","N00003169",122,81,46,35,1,21,21,0,16,14,2,3
"2011","N00003170 (Ballykelly ward)","N00003170",281,159,63,96,0,76,48,28,41,35,6,5
"2011","N00003171 (Coolessan ward)","N00003171",116,47,18,29,1,45,44,1,17,15,2,6
"2011","N00003172 (Coolessan ward)","N00003172",117,38,12,26,0,54,53,1,21,15,6,4
"2011","N00003173 (Coolessan ward)","N00003173",119,65,32,33,1,23,21,2,28,26,2,2
"2011","N00003174 (Coolessan ward)","N00003174",120,32,18,14,0,61,61,0,23,19,4,4
"2011","N00003175 (Coolessan ward)","N00003175",145,75,38,37,0,41,41,0,26,24,2,3
"2011","N00003176 (Dungiven ward)","N00003176",156,122,58,64,2,2,2,0,28,26,2,2
"2011","N00003177 (Dungiven ward)","N00003177",237,128,45,83,1,66,61,5,37,35,2,5
"2011","N00003178 (Dungiven ward)","N00003178",117,87,50,37,0,7,7,0,22,17,5,1
"2011","N00003179 (Dungiven ward)","N00003179",242,130,90,40,2,23,6,17,83,76,7,4
"2011","N00003180 (Enagh ward)","N00003180",107,88,50,38,1,2,2,0,14,13,1,2
"2011","N00003181 (Enagh ward)","N00003181",118,98,49,49,1,3,3,0,16,15,1,0
"2011","N00003182 (Enagh ward)","N00003182",103,88,34,54,0,1,0,1,12,11,1,2
"2011","N00003183 (Enagh ward)","N00003183",147,121,35,86,5,2,1,1,18,18,0,1
"2011","N00003184 (Enagh ward)","N00003184",123,54,13,41,1,52,21,31,14,13,1,2
"2011","N00003185 (Enagh ward)","N00003185",97,48,19,29,0,32,30,2,16,15,1,1
"2011","N00003186 (Enagh ward)","N00003186",125,36,8,28,0,66,64,2,21,21,0,2
"2011","N00003187 (Enagh ward)","N00003187",146,58,36,22,1,45,44,1,37,37,0,5
"2011","N00003188 (Feeny ward)","N00003188",192,165,70,95,0,5,5,0,18,16,2,4
"2011","N00003189 (Feeny ward)","N00003189",118,100,51,49,1,1,1,0,12,8,4,4
"2011","N00003190 (Feeny ward)","N00003190",123,103,63,40,0,2,2,0,11,7,4,7
"2011","N00003191 (Feeny ward)","N00003191",121,73,39,34,2,17,16,1,23,18,5,6
"2011","N00003192 (Feeny ward)","N00003192",154,93,42,51,0,20,19,1,36,31,5,5
"2011","N00003193 (Forest ward)","N00003193",142,114,72,42,2,8,6,2,8,3,5,10
"2011","N00003194 (Forest ward)","N00003194",148,107,63,44,1,13,12,1,24,22,2,3
"2011","N00003195 (Forest ward)","N00003195",182,140,68,72,2,12,12,0,22,18,4,6
"2011","N00003196 (Forest ward)","N00003196",149,118,23,95,2,2,2,0,25,25,0,2
"2011","N00003197 (Forest ward)","N00003197",128,112,52,60,0,1,1,0,14,10,4,1
"2011","N00003198 (Forest ward)","N00003198",110,96,41,55,2,0,0,0,12,10,2,0
"2011","N00003199 (Glack ward)","N00003199",149,135,77,58,0,1,1,0,9,8,1,4
"2011","N00003200 (Glack ward)","N00003200",138,120,67,53,0,3,2,1,6,4,2,9
"2011","N00003201 (Glack ward)","N00003201",152,113,66,47,0,15,15,0,20,18,2,4
"2011","N00003202 (Glack ward)","N00003202",145,129,68,61,1,2,2,0,11,10,1,2
"2011","N00003203 (Glack ward)","N00003203",129,103,67,36,0,3,3,0,19,17,2,4
"2011","N00003204 (Gresteel ward)","N00003204",193,92,32,60,0,69,50,19,29,29,0,3
"2011","N00003205 (Gresteel ward)","N00003205",174,133,60,73,0,15,15,0,20,16,4,6
"2011","N00003206 (Gresteel ward)","N00003206",119,101,54,47,0,6,6,0,10,9,1,2
"2011","N00003207 (Gresteel ward)","N00003207",140,118,70,48,0,6,6,0,10,7,3,6
"2011","N00003208 (Gresteel ward)","N00003208",138,105,48,57,2,10,10,0,16,14,2,5
"2011","N00003209 (Gresteel ward)","N00003209",514,363,76,287,3,7,7,0,140,122,18,1
"2011","N00003210 (Gresteel ward)","N00003210",103,61,25,36,0,13,13,0,24,22,2,5
"2011","N00003211 (Greystone ward)","N00003211",118,50,22,28,0,48,48,0,14,14,0,6
"2011","N00003212 (Greystone ward)","N00003212",141,57,28,29,1,45,45,0,32,26,6,6
"2011","N00003213 (Greystone ward)","N00003213",102,50,27,23,1,26,26,0,18,16,2,7
"2011","N00003214 (Greystone ward)","N00003214",103,25,17,8,0,64,64,0,11,9,2,3
"2011","N00003215 (Greystone ward)","N00003215",118,58,30,28,0,32,31,1,24,22,2,4
"2011","N00003216 (Magilligan ward)","N00003216",135,117,62,55,1,5,5,0,8,7,1,4
"2011","N00003217 (Magilligan ward)","N00003217",118,97,57,40,0,6,6,0,11,8,3,4
"2011","N00003218 (Magilligan ward)","N00003218",144,124,74,50,0,7,7,0,11,11,0,2
"2011","N00003219 (Magilligan ward)","N00003219",120,90,58,32,1,6,5,1,18,14,4,5
"2011","N00003220 (Magilligan ward)","N00003220",135,78,38,40,1,28,28,0,25,22,3,3
"2011","N00003221 (Rathbrady ward)","N00003221",116,107,61,46,0,1,1,0,3,2,1,5
"2011","N00003222 (Rathbrady ward)","N00003222",131,94,55,39,1,11,11,0,24,21,3,1
"2011","N00003223 (Rathbrady ward)","N00003223",129,52,23,29,0,57,57,0,15,15,0,5
"2011","N00003224 (Rathbrady ward)","N00003224",108,83,48,35,1,3,3,0,21,20,1,0
"2011","N00003225 (Rathbrady ward)","N00003225",122,113,79,34,0,1,0,1,6,5,1,2
"2011","N00003226 (Roeside ward)","N00003226",110,92,72,20,0,2,1,1,13,12,1,3
"2011","N00003227 (Roeside ward)","N00003227",101,63,36,27,1,17,17,0,14,13,1,6
"2011","N00003228 (Roeside ward)","N00003228",138,82,47,35,0,6,5,1,43,41,2,7
"2011","N00003229 (Roeside ward)","N00003229",111,48,27,21,1,36,25,11,23,23,0,3
"2011","N00003230 (Roeside ward)","N00003230",126,40,21,19,0,59,36,23,24,20,4,3
"2011","N00003231 (Roeside ward)","N00003231",71,18,11,7,0,28,6,22,22,20,2,3
"2011","N00003232 (The Highlands ward)","N00003232",154,129,69,60,0,2,2,0,18,16,2,5
"2011","N00003233 (The Highlands ward)","N00003233",146,102,55,47,0,30,30,0,8,8,0,6
"2011","N00003234 (The Highlands ward)","N00003234",179,138,63,75,0,14,14,0,20,19,1,7
"2011","N00003235 (The Highlands ward)","N00003235",175,152,84,68,0,5,5,0,17,14,3,1
"2011","N00003236 (Upper Glenshane ward)","N00003236",155,83,28,55,1,24,24,0,45,40,5,2
"2011","N00003237 (Upper Glenshane ward)","N00003237",334,252,111,141,2,8,8,0,66,63,3,6
"2011","N00003238 (Upper Glenshane ward)","N00003238",169,151,82,69,0,5,5,0,12,10,2,1
"2011","N00003239 (Upper Glenshane ward)","N00003239",144,127,73,54,1,3,3,0,11,10,1,2
"2011","N00003624 (Armoy ward)","N00003624",228,175,97,78,1,11,11,0,34,27,7,7
"2011","N00003625 (Armoy ward)","N00003625",156,79,36,43,0,52,46,6,22,21,1,3
"2011","N00003626 (Ballylough ward)","N00003626",141,113,69,44,1,6,6,0,18,15,3,3
"2011","N00003627 (Ballylough ward)","N00003627",147,71,37,34,1,50,48,2,21,20,1,4
"2011","N00003628 (Ballylough ward)","N00003628",151,109,71,38,0,18,18,0,20,17,3,4
"2011","N00003629 (Bonamargy and Rathlin ward)","N00003629",105,81,56,25,0,0,0,0,20,18,2,4
"2011","N00003630 (Bonamargy and Rathlin ward)","N00003630",276,183,139,44,1,31,11,20,56,51,5,5
"2011","N00003631 (Bushmills ward)","N00003631",99,38,25,13,1,40,27,13,15,14,1,5
"2011","N00003632 (Bushmills ward)","N00003632",134,93,70,23,1,15,15,0,20,13,7,5
"2011","N00003633 (Bushmills ward)","N00003633",117,15,12,3,0,91,91,0,7,7,0,4
"2011","N00003634 (Carnmoon ward)","N00003634",136,86,50,36,1,33,33,0,12,8,4,4
"2011","N00003635 (Carnmoon ward)","N00003635",113,93,58,35,0,8,8,0,8,7,1,4
"2011","N00003636 (Carnmoon ward)","N00003636",124,106,66,40,0,3,3,0,10,10,0,5
"2011","N00003637 (Dalriada ward)","N00003637",140,117,77,40,0,2,2,0,17,16,1,4
"2011","N00003638 (Dalriada ward)","N00003638",166,129,63,66,1,2,2,0,32,30,2,2
"2011","N00003639 (Dalriada ward)","N00003639",130,108,68,40,1,2,2,0,15,13,2,4
"2011","N00003640 (Dalriada ward)","N00003640",133,53,20,33,0,45,43,2,29,27,2,6
"2011","N00003641 (Dunseverick ward)","N00003641",168,145,91,54,3,0,0,0,16,15,1,4
"2011","N00003642 (Dunseverick ward)","N00003642",139,103,72,31,0,15,15,0,16,16,0,5
"2011","N00003643 (Glenaan ward)","N00003643",132,98,65,33,0,21,16,5,8,7,1,5
"2011","N00003644 (Glenaan ward)","N00003644",126,103,72,31,0,8,8,0,12,8,4,3
"2011","N00003645 (Glenaan ward)","N00003645",203,129,82,47,0,34,19,15,32,28,4,8
"2011","N00003646 (Glenariff ward)","N00003646",179,138,64,74,0,11,10,1,30,25,5,0
"2011","N00003647 (Glenariff ward)","N00003647",258,177,89,88,2,20,20,0,50,45,5,9
"2011","N00003648 (Glenariff ward)","N00003648",157,129,92,37,2,3,2,1,14,13,1,9
"2011","N00003649 (Glendun ward)","N00003649",143,123,90,33,0,0,0,0,14,11,3,6
"2011","N00003650 (Glendun ward)","N00003650",154,123,85,38,0,4,3,1,24,16,8,3
"2011","N00003651 (Glendun ward)","N00003651",123,70,45,25,1,15,11,4,30,24,6,7
"2011","N00003652 (Glenshesk ward)","N00003652",218,174,124,50,0,6,6,0,26,24,2,12
"2011","N00003653 (Glenshesk ward)","N00003653",137,98,57,41,0,10,10,0,24,22,2,5
"2011","N00003654 (Glentaisie ward)","N00003654",101,45,27,18,1,33,33,0,16,15,1,6
"2011","N00003655 (Glentaisie ward)","N00003655",113,43,30,13,1,40,37,3,23,18,5,6
"2011","N00003656 (Glentaisie ward)","N00003656",185,116,40,76,2,2,2,0,64,60,4,1
"2011","N00003657 (Glentaisie ward)","N00003657",165,88,57,31,0,19,9,10,53,50,3,5
"2011","N00003658 (Kinbane ward)","N00003658",188,142,92,50,0,15,15,0,25,20,5,6
"2011","N00003659 (Kinbane ward)","N00003659",145,105,68,37,0,17,15,2,20,16,4,3
"2011","N00003660 (Knocklayd ward)","N00003660",147,103,53,50,0,29,28,1,13,12,1,2
"2011","N00003661 (Knocklayd ward)","N00003661",161,86,41,45,0,34,16,18,39,35,4,2
"2011","N00003662 (Knocklayd ward)","N00003662",110,50,24,26,0,41,30,11,14,13,1,5
"2011","N00003663 (Knocklayd ward)","N00003663",106,42,18,24,0,43,31,12,21,20,1,0
"2011","N00003664 (Knocklayd ward)","N00003664",194,132,48,84,1,3,2,1,57,52,5,1
"2011","N00003665 (Moss-Side and Moyarget ward)","N00003665",177,132,81,51,1,18,18,0,20,15,5,6
"2011","N00003666 (Moss-Side and Moyarget ward)","N00003666",183,110,58,52,1,40,40,0,25,21,4,7
"2011","N00002396 (Altnagelvin ward)","N00002396",132,56,34,22,1,45,43,2,25,25,0,5
"2011","N00002397 (Altnagelvin ward)","N00002397",147,34,12,22,1,88,88,0,22,21,1,2
"2011","N00002398 (Altnagelvin ward)","N00002398",137,49,21,28,0,71,71,0,11,10,1,6
"2011","N00002399 (Altnagelvin ward)","N00002399",117,35,10,25,1,68,67,1,12,10,2,1
"2011","N00002400 (Altnagelvin ward)","N00002400",70,56,36,20,0,6,6,0,6,4,2,2
"2011","N00002401 (Altnagelvin ward)","N00002401",555,355,70,285,6,12,3,9,176,166,10,6
"2011","N00002402 (Altnagelvin ward)","N00002402",96,87,50,37,0,0,0,0,7,5,2,2
"2011","N00002403 (Altnagelvin ward)","N00002403",176,134,81,53,1,0,0,0,39,37,2,2
"2011","N00002404 (Altnagelvin ward)","N00002404",339,242,80,162,3,45,44,1,43,42,1,6
"2011","N00002405 (Altnagelvin ward)","N00002405",128,90,49,41,0,11,11,0,26,24,2,1
"2011","N00002406 (Ballynashallog ward)","N00002406",109,100,60,40,0,2,0,2,7,4,3,0
"2011","N00002407 (Ballynashallog ward)","N00002407",112,92,59,33,0,8,8,0,10,9,1,2
"2011","N00002408 (Ballynashallog ward)","N00002408",129,121,78,43,0,0,0,0,8,5,3,0
"2011","N00002409 (Ballynashallog ward)","N00002409",131,89,47,42,0,23,21,2,16,11,5,3
"2011","N00002410 (Ballynashallog ward)","N00002410",117,84,50,34,0,15,15,0,14,10,4,4
"2011","N00002411 (Ballynashallog ward)","N00002411",107,104,54,50,0,0,0,0,2,2,0,1
"2011","N00002412 (Ballynashallog ward)","N00002412",110,103,41,62,0,1,1,0,4,4,0,2
"2011","N00002413 (Ballynashallog ward)","N00002413",123,109,43,66,1,1,1,0,12,10,2,0
"2011","N00002414 (Ballynashallog ward)","N00002414",103,90,51,39,0,1,1,0,9,5,4,3
"2011","N00002415 (Ballynashallog ward)","N00002415",103,88,47,41,1,1,1,0,11,10,1,2
"2011","N00002416 (Banagher ward)","N00002416",180,120,51,69,1,40,37,3,11,8,3,8
"2011","N00002417 (Banagher ward)","N00002417",120,92,49,43,1,8,8,0,17,12,5,2
"2011","N00002418 (Banagher ward)","N00002418",169,140,76,64,0,11,11,0,16,11,5,2
"2011","N00002419 (Banagher ward)","N00002419",230,175,75,100,0,5,5,0,46,39,7,4
"2011","N00002420 (Banagher ward)","N00002420",163,138,82,56,1,3,2,1,18,14,4,3
"2011","N00002421 (Banagher ward)","N00002421",131,115,73,42,0,5,3,2,9,7,2,2
"2011","N00002422 (Banagher ward)","N00002422",162,134,73,61,1,9,9,0,12,10,2,6
"2011","N00002423 (Beechwood ward)","N00002423",115,43,24,19,0,62,22,40,6,4,2,4
"2011","N00002424 (Beechwood ward)","N00002424",129,95,52,43,3,10,3,7,21,20,1,0
"2011","N00002425 (Beechwood ward)","N00002425",127,89,46,43,0,8,8,0,29,23,6,1
"2011","N00002426 (Beechwood ward)","N00002426",132,108,57,51,0,5,5,0,19,18,1,0
"2011","N00002427 (Beechwood ward)","N00002427",127,70,24,46,1,34,31,3,14,12,2,8
"2011","N00002428 (Beechwood ward)","N00002428",125,71,25,46,0,36,34,2,14,12,2,4
"2011","N00002429 (Beechwood ward)","N00002429",135,69,25,44,1,51,46,5,9,5,4,5
"2011","N00002430 (Brandywell ward)","N00002430",131,44,21,23,1,77,66,11,6,4,2,3
"2011","N00002431 (Brandywell ward)","N00002431",423,112,46,66,0,241,166,75,45,42,3,25
"2011","N00002432 (Brandywell ward)","N00002432",119,41,17,24,0,59,57,2,13,12,1,6
"2011","N00002433 (Brandywell ward)","N00002433",135,88,40,48,0,26,20,6,20,18,2,1
"2011","N00002434 (Brandywell ward)","N00002434",102,21,9,12,0,70,26,44,9,8,1,2
"2011","N00002435 (Brandywell ward)","N00002435",152,51,29,22,0,81,44,37,16,13,3,4
"2011","N00002436 (Carn Hill ward)","N00002436",154,79,30,49,1,48,40,8,24,23,1,2
"2011","N00002437 (Carn Hill ward)","N00002437",88,67,22,45,1,4,4,0,14,14,0,2
"2011","N00002438 (Carn Hill ward)","N00002438",127,80,32,48,0,30,28,2,15,14,1,2
"2011","N00002439 (Carn Hill ward)","N00002439",120,66,25,41,0,36,31,5,12,12,0,6
"2011","N00002440 (Carn Hill ward)","N00002440",110,52,15,37,1,30,28,2,24,22,2,3
"2011","N00002441 (Carn Hill ward)","N00002441",112,47,19,28,0,48,44,4,11,9,2,6
"2011","N00002442 (Carn Hill ward)","N00002442",110,46,10,36,0,48,46,2,12,10,2,4
"2011","N00002443 (Carn Hill ward)","N00002443",128,66,23,43,0,36,29,7,22,19,3,4
"2011","N00002444 (Caw ward)","N00002444",372,184,76,108,3,122,67,55,51,48,3,12
"2011","N00002445 (Caw ward)","N00002445",147,124,93,31,1,2,0,2,17,14,3,3
"2011","N00002446 (Caw ward)","N00002446",133,42,20,22,0,75,75,0,11,11,0,5
"2011","N00002447 (Caw ward)","N00002447",153,44,19,25,0,90,90,0,15,13,2,4
"2011","N00002448 (Caw ward)","N00002448",131,49,24,25,2,62,61,1,14,13,1,4
"2011","N00002449 (Caw ward)","N00002449",134,73,36,37,0,46,46,0,11,10,1,4
"2011","N00002450 (Caw ward)","N00002450",131,72,40,32,0,41,40,1,14,12,2,4
"2011","N00002451 (Clondermot ward)","N00002451",284,82,39,43,0,134,131,3,56,53,3,12
"2011","N00002452 (Clondermot ward)","N00002452",121,66,37,29,0,33,16,17,18,15,3,4
"2011","N00002453 (Clondermot ward)","N00002453",157,85,47,38,0,48,5,43,22,17,5,2
"2011","N00002454 (Clondermot ward)","N00002454",200,80,44,36,0,108,7,101,8,8,0,4
"2011","N00002455 (Clondermot ward)","N00002455",128,110,42,68,1,0,0,0,15,13,2,2
"2011","N00002456 (Clondermot ward)","N00002456",146,126,67,59,1,1,1,0,17,13,4,1
"2011","N00002457 (Clondermot ward)","N00002457",202,162,72,90,3,1,1,0,30,27,3,6
"2011","N00002458 (Claudy ward)","N00002458",134,74,49,25,0,30,30,0,25,25,0,5
"2011","N00002459 (Claudy ward)","N00002459",296,194,82,112,1,54,26,28,37,37,0,10
"2011","N00002460 (Claudy ward)","N00002460",154,113,31,82,1,5,2,3,31,28,3,4
"2011","N00002461 (Claudy ward)","N00002461",180,163,71,92,0,3,2,1,10,8,2,4
"2011","N00002462 (Claudy ward)","N00002462",178,155,80,75,0,3,3,0,15,11,4,5
"2011","N00002463 (Claudy ward)","N00002463",136,116,68,48,0,3,3,0,13,12,1,4
"2011","N00002464 (Claudy ward)","N00002464",142,114,61,53,0,9,9,0,12,11,1,7
"2011","N00002465 (Creggan Central ward)","N00002465",270,45,8,37,0,201,138,63,8,7,1,16
"2011","N00002466 (Creggan Central ward)","N00002466",110,32,11,21,0,66,61,5,8,6,2,4
"2011","N00002467 (Creggan Central ward)","N00002467",115,43,13,30,0,57,54,3,9,7,2,6
"2011","N00002468 (Creggan Central ward)","N00002468",116,70,23,47,1,18,6,12,27,25,2,0
"2011","N00002469 (Creggan Central ward)","N00002469",232,95,28,67,1,94,50,44,38,32,6,4
"2011","N00002470 (Creggan Central ward)","N00002470",144,89,33,56,1,43,38,5,8,5,3,3
"2011","N00002471 (Creggan South ward)","N00002471",118,62,22,40,0,43,42,1,6,5,1,7
"2011","N00002472 (Creggan South ward)","N00002472",167,58,16,42,0,99,78,21,8,6,2,2
"2011","N00002473 (Creggan South ward)","N00002473",125,35,5,30,0,81,70,11,6,6,0,3
"2011","N00002474 (Creggan South ward)","N00002474",135,56,21,35,0,63,53,10,11,9,2,5
"2011","N00002475 (Creggan South ward)","N00002475",164,56,22,34,1,87,82,5,9,8,1,11
"2011","N00002476 (Creggan South ward)","N00002476",146,80,37,43,0,46,44,2,15,15,0,5
"2011","N00002477 (Crevagh ward)","N00002477",115,57,23,34,0,39,36,3,11,7,4,8
"2011","N00002478 (Crevagh ward)","N00002478",191,47,10,37,0,123,44,79,17,11,6,4
"2011","N00002479 (Crevagh ward)","N00002479",140,120,50,70,0,4,2,2,16,14,2,0
"2011","N00002480 (Crevagh ward)","N00002480",216,167,66,101,1,17,16,1,24,22,2,7
"2011","N00002481 (Crevagh ward)","N00002481",127,39,4,35,1,65,58,7,12,11,1,10
"2011","N00002482 (Crevagh ward)","N00002482",118,37,5,32,0,66,64,2,13,11,2,2
"2011","N00002483 (Crevagh ward)","N00002483",125,29,7,22,0,78,72,6,13,10,3,5
"2011","N00002484 (Crevagh ward)","N00002484",129,33,10,23,2,77,72,5,13,13,0,4
"2011","N00002485 (Crevagh ward)","N00002485",103,34,8,26,1,47,37,10,16,12,4,5
"2011","N00002486 (Crevagh ward)","N00002486",153,53,3,50,0,78,34,44,20,9,11,2
"2011","N00002487 (Crevagh ward)","N00002487",142,104,12,92,4,15,6,9,18,17,1,1
"2011","N00002488 (Crevagh ward)","N00002488",417,189,34,155,0,130,20,110,92,77,15,6
"2011","N00002489 (Culmore ward)","N00002489",263,228,89,139,3,4,4,0,24,21,3,4
"2011","N00002490 (Culmore ward)","N00002490",138,100,37,63,2,11,6,5,23,20,3,2
"2011","N00002491 (Culmore ward)","N00002491",138,39,7,32,2,78,68,10,13,12,1,6
"2011","N00002492 (Culmore ward)","N00002492",114,38,8,30,0,63,51,12,10,10,0,3
"2011","N00002493 (Culmore ward)","N00002493",136,38,14,24,0,83,75,8,12,7,5,3
"2011","N00002494 (Culmore ward)","N00002494",105,26,10,16,0,70,69,1,5,4,1,4
"2011","N00002495 (Culmore ward)","N00002495",208,105,21,84,2,57,31,26,41,37,4,3
"2011","N00002496 (Culmore ward)","N00002496",121,43,10,33,3,62,56,6,9,7,2,4
"2011","N00002497 (Culmore ward)","N00002497",222,65,16,49,0,132,50,82,17,13,4,8
"2011","N00002498 (Culmore ward)","N00002498",431,157,24,133,1,194,105,89,73,67,6,6
"2011","N00002499 (Culmore ward)","N00002499",239,118,17,101,1,8,7,1,112,111,1,0
"2011","N00002500 (Culmore ward)","N00002500",179,129,18,111,3,7,5,2,40,37,3,0
"2011","N00002501 (Culmore ward)","N00002501",523,436,93,343,0,5,3,2,79,69,10,3
"2011","N00002502 (Culmore ward)","N00002502",173,132,50,82,2,10,9,1,27,25,2,2
"2011","N00002503 (Ebrington ward)","N00002503",106,89,60,29,0,10,10,0,6,4,2,1
"2011","N00002504 (Ebrington ward)","N00002504",136,35,14,21,0,85,46,39,9,6,3,7
"2011","N00002505 (Ebrington ward)","N00002505",129,62,34,28,0,16,15,1,50,44,6,1
"2011","N00002506 (Ebrington ward)","N00002506",128,63,41,22,2,5,5,0,55,48,7,3
"2011","N00002507 (Ebrington ward)","N00002507",114,51,19,32,1,45,45,0,15,15,0,2
"2011","N00002508 (Ebrington ward)","N00002508",102,34,20,14,0,9,5,4,57,53,4,2
"2011","N00002509 (Ebrington ward)","N00002509",151,43,29,14,0,47,29,18,54,52,2,7
"2011","N00002510 (Ebrington ward)","N00002510",216,86,36,50,2,32,18,14,93,89,4,3
"2011","N00002511 (Ebrington ward)","N00002511",94,19,7,12,0,50,49,1,21,20,1,4
"2011","N00002512 (Eglinton ward)","N00002512",311,167,84,83,0,85,51,34,51,48,3,8
"2011","N00002513 (Eglinton ward)","N00002513",116,101,60,41,0,3,1,2,11,10,1,1
"2011","N00002514 (Eglinton ward)","N00002514",122,115,42,73,0,2,0,2,4,3,1,1
"2011","N00002515 (Eglinton ward)","N00002515",107,88,60,28,1,2,2,0,15,12,3,1
"2011","N00002516 (Eglinton ward)","N00002516",125,108,61,47,0,2,1,1,12,9,3,3
"2011","N00002517 (Eglinton ward)","N00002517",133,88,43,45,0,27,12,15,16,14,2,2
"2011","N00002518 (Eglinton ward)","N00002518",251,160,63,97,2,13,7,6,73,73,0,3
"2011","N00002519 (Eglinton ward)","N00002519",131,90,33,57,1,5,1,4,32,30,2,3
"2011","N00002520 (Eglinton ward)","N00002520",274,242,68,174,1,3,0,3,26,21,5,2
"2011","N00002521 (Enagh ward)","N00002521",505,251,46,205,4,119,117,2,121,115,6,10
"2011","N00002522 (Enagh ward)","N00002522",122,37,12,25,2,60,60,0,19,15,4,4
"2011","N00002523 (Enagh ward)","N00002523",123,85,44,41,1,21,20,1,16,15,1,0
"2011","N00002524 (Enagh ward)","N00002524",163,84,25,59,2,45,44,1,31,31,0,1
"2011","N00002525 (Enagh ward)","N00002525",634,442,149,293,4,18,17,1,161,153,8,9
"2011","N00002526 (Enagh ward)","N00002526",381,264,109,155,2,7,5,2,103,96,7,5
"2011","N00002527 (Enagh ward)","N00002527",151,137,71,66,0,2,0,2,11,10,1,1
"2011","N00002528 (Foyle Springs ward)","N00002528",95,82,21,61,2,2,0,2,9,9,0,0
"2011","N00002529 (Foyle Springs ward)","N00002529",124,113,52,61,1,0,0,0,10,8,2,0
"2011","N00002530 (Foyle Springs ward)","N00002530",120,96,18,78,0,0,0,0,24,23,1,0
"2011","N00002531 (Foyle Springs ward)","N00002531",152,135,35,100,0,1,0,1,15,15,0,1
"2011","N00002532 (Foyle Springs ward)","N00002532",119,91,33,58,3,1,0,1,20,18,2,4
"2011","N00002533 (Foyle Springs ward)","N00002533",408,192,96,96,2,127,93,34,72,66,6,15
"2011","N00002534 (Foyle Springs ward)","N00002534",191,86,49,37,0,50,49,1,48,44,4,7
"2011","N00002535 (Foyle Springs ward)","N00002535",138,128,54,74,0,2,2,0,7,6,1,1
"2011","N00002536 (Holly Mount ward)","N00002536",209,177,79,98,0,0,0,0,29,28,1,3
"2011","N00002537 (Holly Mount ward)","N00002537",575,429,208,221,2,54,54,0,81,65,16,9
"2011","N00002538 (Holly Mount ward)","N00002538",238,194,75,119,0,4,3,1,39,36,3,1
"2011","N00002539 (Holly Mount ward)","N00002539",115,52,24,28,0,44,42,2,10,10,0,9
"2011","N00002540 (Holly Mount ward)","N00002540",629,503,95,408,2,16,13,3,98,90,8,10
"2011","N00002541 (Kilfennan ward)","N00002541",522,433,256,177,9,4,4,0,72,64,8,4
"2011","N00002542 (Kilfennan ward)","N00002542",112,100,45,55,1,0,0,0,11,8,3,0
"2011","N00002543 (Kilfennan ward)","N00002543",115,64,22,42,6,1,1,0,44,41,3,0
"2011","N00002544 (Kilfennan ward)","N00002544",279,173,62,111,8,9,1,8,87,81,6,2
"2011","N00002545 (Kilfennan ward)","N00002545",127,73,24,49,11,1,0,1,42,41,1,0
"2011","N00002546 (Kilfennan ward)","N00002546",114,50,15,35,6,2,1,1,56,55,1,0
"2011","N00002547 (Lisnagelvin ward)","N00002547",437,340,189,151,1,29,28,1,58,53,5,9
"2011","N00002548 (Lisnagelvin ward)","N00002548",279,101,34,67,1,149,123,26,15,14,1,13
"2011","N00002549 (Lisnagelvin ward)","N00002549",114,82,59,23,0,3,3,0,25,24,1,4
"2011","N00002550 (Lisnagelvin ward)","N00002550",117,78,50,28,2,8,8,0,23,22,1,6
"2011","N00002551 (Lisnagelvin ward)","N00002551",146,92,50,42,1,23,23,0,26,24,2,4
"2011","N00002552 (Lisnagelvin ward)","N00002552",117,59,27,32,1,39,39,0,13,11,2,5
"2011","N00002553 (Lisnagelvin ward)","N00002553",125,81,54,27,0,15,15,0,28,23,5,1
"2011","N00002554 (Lisnagelvin ward)","N00002554",134,93,43,50,0,3,3,0,33,29,4,5
"2011","N00002555 (New Buildings ward)","N00002555",128,110,42,68,1,4,4,0,10,10,0,3
"2011","N00002556 (New Buildings ward)","N00002556",122,78,32,46,1,27,26,1,15,12,3,1
"2011","N00002557 (New Buildings ward)","N00002557",130,98,45,53,0,17,17,0,13,11,2,2
"2011","N00002558 (New Buildings ward)","N00002558",115,84,36,48,2,13,13,0,11,9,2,5
"2011","N00002559 (New Buildings ward)","N00002559",116,61,20,41,1,37,37,0,15,15,0,2
"2011","N00002560 (New Buildings ward)","N00002560",152,135,50,85,0,6,4,2,11,9,2,0
"2011","N00002561 (New Buildings ward)","N00002561",120,116,67,49,1,0,0,0,3,2,1,0
"2011","N00002562 (New Buildings ward)","N00002562",128,113,51,62,1,3,3,0,8,7,1,3
"2011","N00002563 (New Buildings ward)","N00002563",131,120,54,66,1,1,1,0,8,5,3,1
"2011","N00002564 (New Buildings ward)","N00002564",112,80,47,33,0,12,12,0,17,15,2,3
"2011","N00002565 (Pennyburn ward)","N00002565",116,73,43,30,0,4,2,2,33,30,3,6
"2011","N00002566 (Pennyburn ward)","N00002566",122,109,77,32,0,0,0,0,12,10,2,1
"2011","N00002567 (Pennyburn ward)","N00002567",120,83,39,44,0,4,3,1,30,27,3,3
"2011","N00002568 (Pennyburn ward)","N00002568",119,97,61,36,0,3,0,3,17,16,1,2
"2011","N00002569 (Pennyburn ward)","N00002569",121,101,74,27,0,1,0,1,13,13,0,6
"2011","N00002570 (Pennyburn ward)","N00002570",120,59,30,29,0,42,2,40,14,12,2,5
"2011","N00002571 (Pennyburn ward)","N00002571",126,110,73,37,3,3,3,0,8,6,2,2
"2011","N00002572 (Pennyburn ward)","N00002572",129,117,67,50,0,0,0,0,11,9,2,1
"2011","N00002573 (Rosemount ward)","N00002573",136,69,32,37,2,37,26,11,20,17,3,8
"2011","N00002574 (Rosemount ward)","N00002574",122,64,37,27,1,11,9,2,43,38,5,3
"2011","N00002575 (Rosemount ward)","N00002575",126,59,25,34,1,38,36,2,24,23,1,4
"2011","N00002576 (Rosemount ward)","N00002576",320,143,73,70,0,25,20,5,148,136,12,4
"2011","N00002577 (Rosemount ward)","N00002577",241,95,58,37,0,44,14,30,98,94,4,4
"2011","N00002578 (Rosemount ward)","N00002578",129,45,18,27,0,16,12,4,66,65,1,2
"2011","N00002579 (Shantallow East ward)","N00002579",131,55,20,35,0,60,51,9,9,7,2,7
"2011","N00002580 (Shantallow East ward)","N00002580",113,85,56,29,1,21,16,5,4,4,0,2
"2011","N00002581 (Shantallow East ward)","N00002581",129,107,65,42,0,6,3,3,14,11,3,2
"2011","N00002582 (Shantallow East ward)","N00002582",519,180,62,118,1,265,204,61,47,42,5,26
"2011","N00002583 (Shantallow West ward)","N00002583",113,26,6,20,0,78,74,4,4,4,0,5
"2011","N00002584 (Shantallow West ward)","N00002584",127,41,8,33,0,71,65,6,12,12,0,3
"2011","N00002585 (Shantallow West ward)","N00002585",108,38,11,27,0,57,53,4,9,9,0,4
"2011","N00002586 (Shantallow West ward)","N00002586",126,45,5,40,1,67,60,7,9,8,1,4
"2011","N00002587 (Shantallow West ward)","N00002587",288,71,10,61,1,191,138,53,15,14,1,10
"2011","N00002588 (Shantallow West ward)","N00002588",110,30,6,24,1,74,62,12,4,4,0,1
"2011","N00002589 (Shantallow West ward)","N00002589",106,38,4,34,1,55,41,14,9,8,1,3
"2011","N00002590 (Shantallow West ward)","N00002590",528,185,26,159,0,249,119,130,90,81,9,4
"2011","N00002591 (Shantallow West ward)","N00002591",396,217,48,169,4,126,25,101,45,36,9,4
"2011","N00002592 (Shantallow West ward)","N00002592",149,132,29,103,1,5,0,5,11,10,1,0
"2011","N00002593 (Shantallow West ward)","N00002593",137,61,16,45,0,48,8,40,26,25,1,2
"2011","N00002594 (Springtown ward)","N00002594",127,34,10,24,0,77,68,9,15,11,4,1
"2011","N00002595 (Springtown ward)","N00002595",139,73,18,55,0,45,34,11,15,13,2,6
"2011","N00002596 (Springtown ward)","N00002596",120,98,41,57,3,5,4,1,14,10,4,0
"2011","N00002597 (Springtown ward)","N00002597",107,72,22,50,4,5,4,1,26,24,2,0
"2011","N00002598 (Springtown ward)","N00002598",104,32,4,28,0,52,51,1,10,8,2,10
"2011","N00002599 (Springtown ward)","N00002599",127,110,37,73,9,3,2,1,4,3,1,1
"2011","N00002600 (Springtown ward)","N00002600",101,90,32,58,3,2,2,0,5,5,0,1
"2011","N00002601 (Springtown ward)","N00002601",124,103,44,59,2,0,0,0,18,17,1,1
"2011","N00002602 (Springtown ward)","N00002602",107,95,42,53,1,1,1,0,9,9,0,1
"2011","N00002603 (Strand ward)","N00002603",443,96,66,30,2,176,56,120,164,155,9,5
"2011","N00002604 (Strand ward)","N00002604",138,52,42,10,0,7,5,2,77,73,4,2
"2011","N00002605 (Strand ward)","N00002605",162,18,12,6,1,61,30,31,80,75,5,2
"2011","N00002606 (Strand ward)","N00002606",195,51,13,38,2,92,61,31,44,41,3,6
"2011","N00002607 (Strand ward)","N00002607",107,31,14,17,0,62,61,1,11,11,0,3
"2011","N00002608 (Strand ward)","N00002608",137,52,29,23,0,17,3,14,68,60,8,0
"2011","N00002609 (Strand ward)","N00002609",123,107,68,39,0,2,1,1,12,11,1,2
"2011","N00002610 (Strand ward)","N00002610",122,53,26,27,0,21,7,14,47,42,5,1
"2011","N00002611 (Strand ward)","N00002611",64,32,18,14,0,4,1,3,26,25,1,2
"2011","N00002612 (Strand ward)","N00002612",123,40,21,19,0,13,6,7,70,64,6,0
"2011","N00002613 (The Diamond ward)","N00002613",391,55,37,18,1,186,99,87,132,124,8,17
"2011","N00002614 (The Diamond ward)","N00002614",153,80,38,42,0,5,4,1,68,64,4,0
"2011","N00002615 (The Diamond ward)","N00002615",112,67,31,36,0,22,19,3,22,21,1,1
"2011","N00002616 (The Diamond ward)","N00002616",169,70,45,25,0,39,25,14,57,54,3,3
"2011","N00002617 (The Diamond ward)","N00002617",164,92,44,48,0,22,20,2,45,43,2,5
"2011","N00002618 (The Diamond ward)","N00002618",106,42,17,25,0,51,49,2,7,7,0,6
"2011","N00002619 (Victoria ward)","N00002619",311,110,58,52,2,19,7,12,178,174,4,2
"2011","N00002620 (Victoria ward)","N00002620",241,92,30,62,2,52,43,9,88,85,3,7
"2011","N00002621 (Victoria ward)","N00002621",119,66,39,27,0,29,29,0,22,21,1,2
"2011","N00002622 (Victoria ward)","N00002622",145,73,32,41,1,12,8,4,58,57,1,1
"2011","N00002623 (Victoria ward)","N00002623",115,84,45,39,0,23,23,0,6,6,0,2
"2011","N00002624 (Victoria ward)","N00002624",127,53,26,27,0,13,11,2,58,56,2,3
"2011","N00002625 (Victoria ward)","N00002625",138,54,16,38,1,44,43,1,36,33,3,3
"2011","N00002626 (Victoria ward)","N00002626",294,208,36,172,4,30,24,6,47,44,3,5
"2011","N00002627 (Westland ward)","N00002627",150,71,41,30,1,55,28,27,17,16,1,6
"2011","N00002628 (Westland ward)","N00002628",398,232,119,113,2,68,35,33,83,74,9,13
"2011","N00002629 (Westland ward)","N00002629",122,51,26,25,1,54,52,2,8,7,1,8
"2011","N00002630 (Westland ward)","N00002630",108,44,18,26,1,52,40,12,6,6,0,5
"2011","N00002631 (Westland ward)","N00002631",125,74,35,39,0,19,17,2,25,24,1,7
"2011","N00004446 (Artigarvan ward)","N00004446",176,115,37,78,0,27,27,0,29,26,3,5
"2011","N00004447 (Artigarvan ward)","N00004447",148,90,45,45,3,28,28,0,22,19,3,5
"2011","N00004448 (Artigarvan ward)","N00004448",171,147,83,64,1,5,5,0,16,12,4,2
"2011","N00004449 (Artigarvan ward)","N00004449",160,124,76,48,2,2,2,0,28,25,3,4
"2011","N00004450 (Artigarvan ward)","N00004450",146,131,88,43,1,2,1,1,10,9,1,2
"2011","N00004451 (Artigarvan ward)","N00004451",193,152,69,83,2,11,10,1,20,19,1,8
"2011","N00004452 (Ballycolman ward)","N00004452",129,72,40,32,0,48,48,0,7,6,1,2
"2011","N00004453 (Ballycolman ward)","N00004453",125,53,16,37,0,54,51,3,14,12,2,4
"2011","N00004454 (Ballycolman ward)","N00004454",120,45,20,25,0,49,48,1,16,15,1,10
"2011","N00004455 (Ballycolman ward)","N00004455",124,70,29,41,0,42,41,1,9,9,0,3
"2011","N00004456 (Ballycolman ward)","N00004456",128,58,16,42,0,53,53,0,14,12,2,3
"2011","N00004457 (Ballycolman ward)","N00004457",125,92,53,39,0,15,14,1,14,14,0,4
"2011","N00004458 (Castlederg ward)","N00004458",128,101,68,33,0,5,5,0,16,13,3,6
"2011","N00004459 (Castlederg ward)","N00004459",334,176,85,91,0,58,32,26,89,85,4,11
"2011","N00004460 (Castlederg ward)","N00004460",118,62,37,25,0,21,21,0,29,25,4,6
"2011","N00004461 (Castlederg ward)","N00004461",161,80,43,37,1,33,32,1,41,39,2,6
"2011","N00004462 (Castlederg ward)","N00004462",143,57,32,25,1,46,43,3,33,31,2,6
"2011","N00004463 (Clare ward)","N00004463",159,128,78,50,0,1,1,0,22,18,4,8
"2011","N00004464 (Clare ward)","N00004464",146,84,43,41,0,37,36,1,19,17,2,6
"2011","N00004465 (Clare ward)","N00004465",154,116,62,54,2,1,1,0,27,19,8,8
"2011","N00004466 (Clare ward)","N00004466",151,90,55,35,0,21,20,1,35,30,5,5
"2011","N00004467 (Clare ward)","N00004467",141,121,83,38,0,1,1,0,13,9,4,6
"2011","N00004468 (Clare ward)","N00004468",160,125,68,57,0,5,5,0,20,16,4,10
"2011","N00004469 (Dunnamanagh ward)","N00004469",138,91,51,40,0,23,23,0,20,18,2,4
"2011","N00004470 (Dunnamanagh ward)","N00004470",132,46,29,17,0,62,61,1,14,12,2,10
"2011","N00004471 (Dunnamanagh ward)","N00004471",144,126,93,33,1,1,0,1,14,13,1,2
"2011","N00004472 (Dunnamanagh ward)","N00004472",244,217,141,76,0,6,5,1,13,13,0,8
"2011","N00004473 (Dunnamanagh ward)","N00004473",111,93,57,36,0,8,8,0,8,4,4,2
"2011","N00004474 (East ward)","N00004474",410,177,99,78,0,137,107,30,76,71,5,20
"2011","N00004475 (East ward)","N00004475",130,25,7,18,0,87,84,3,10,10,0,8
"2011","N00004476 (East ward)","N00004476",119,44,18,26,0,56,55,1,10,8,2,9
"2011","N00004477 (East ward)","N00004477",127,25,13,12,0,83,82,1,13,12,1,6
"2011","N00004478 (Finn ward)","N00004478",193,154,78,76,2,4,4,0,27,22,5,6
"2011","N00004479 (Finn ward)","N00004479",175,145,60,85,0,2,2,0,28,23,5,0
"2011","N00004480 (Finn ward)","N00004480",169,117,57,60,0,20,20,0,29,28,1,3
"2011","N00004481 (Finn ward)","N00004481",199,147,73,74,1,9,8,1,36,35,1,6
"2011","N00004482 (Finn ward)","N00004482",131,89,57,32,1,16,13,3,18,18,0,7
"2011","N00004483 (Finn ward)","N00004483",143,52,26,26,1,56,56,0,28,27,1,6
"2011","N00004484 (Glenderg ward)","N00004484",220,149,70,79,1,6,2,4,62,58,4,2
"2011","N00004485 (Glenderg ward)","N00004485",143,126,94,32,0,4,4,0,11,7,4,2
"2011","N00004486 (Glenderg ward)","N00004486",152,49,25,24,0,71,65,6,22,22,0,10
"2011","N00004487 (Glenderg ward)","N00004487",143,123,79,44,0,3,2,1,14,13,1,3
"2011","N00004488 (Glenderg ward)","N00004488",143,125,80,45,0,1,1,0,13,11,2,4
"2011","N00004489 (Glenderg ward)","N00004489",133,93,66,27,0,13,13,0,19,18,1,8
"2011","N00004490 (Newtownstewart ward)","N00004490",185,117,61,56,0,34,28,6,23,22,1,11
"2011","N00004491 (Newtownstewart ward)","N00004491",147,59,41,18,0,48,37,11,25,23,2,15
"2011","N00004492 (Newtownstewart ward)","N00004492",129,97,64,33,0,4,4,0,24,23,1,4
"2011","N00004493 (Newtownstewart ward)","N00004493",153,110,63,47,0,3,1,2,32,28,4,8
"2011","N00004494 (Newtownstewart ward)","N00004494",137,48,26,22,0,69,41,28,14,12,2,6
"2011","N00004495 (Newtownstewart ward)","N00004495",130,38,12,26,1,64,62,2,16,12,4,11
"2011","N00004496 (North ward)","N00004496",331,246,119,127,1,6,4,2,73,69,4,5
"2011","N00004497 (North ward)","N00004497",177,80,51,29,1,34,9,25,59,59,0,3
"2011","N00004498 (North ward)","N00004498",539,364,146,218,3,35,7,28,128,117,11,9
"2011","N00004499 (North ward)","N00004499",111,41,25,16,0,44,13,31,20,16,4,6
"2011","N00004500 (North ward)","N00004500",104,50,29,21,0,12,6,6,41,38,3,1
"2011","N00004501 (Plumbridge ward)","N00004501",138,121,81,40,0,2,1,1,11,10,1,4
"2011","N00004502 (Plumbridge ward)","N00004502",106,87,53,34,0,7,1,6,8,5,3,4
"2011","N00004503 (Plumbridge ward)","N00004503",123,113,71,42,1,2,2,0,6,4,2,1
"2011","N00004504 (Plumbridge ward)","N00004504",115,52,34,18,0,33,32,1,23,16,7,7
"2011","N00004505 (Plumbridge ward)","N00004505",134,114,71,43,1,3,1,2,9,8,1,7
"2011","N00004506 (Plumbridge ward)","N00004506",129,101,65,36,1,4,2,2,18,13,5,5
"2011","N00004507 (Sion Mills ward)","N00004507",123,78,49,29,0,26,25,1,15,12,3,4
"2011","N00004508 (Sion Mills ward)","N00004508",260,149,79,70,2,59,28,31,32,27,5,18
"2011","N00004509 (Sion Mills ward)","N00004509",112,74,35,39,1,4,0,4,31,30,1,2
"2011","N00004510 (Sion Mills ward)","N00004510",128,61,29,32,0,52,52,0,8,6,2,7
"2011","N00004511 (Sion Mills ward)","N00004511",100,60,36,24,0,10,9,1,27,23,4,3
"2011","N00004512 (Sion Mills ward)","N00004512",145,107,52,55,2,17,16,1,17,14,3,2
"2011","N00004513 (Slievekirk ward)","N00004513",148,102,55,47,0,22,18,4,22,20,2,2
"2011","N00004514 (Slievekirk ward)","N00004514",204,156,76,80,0,8,6,2,33,29,4,7
"2011","N00004515 (Slievekirk ward)","N00004515",132,120,67,53,0,1,0,1,8,6,2,3
"2011","N00004516 (Slievekirk ward)","N00004516",137,113,54,59,0,10,4,6,11,7,4,3
"2011","N00004517 (Slievekirk ward)","N00004517",132,100,59,41,0,2,2,0,20,14,6,10
"2011","N00004518 (Slievekirk ward)","N00004518",126,67,42,25,0,33,33,0,20,18,2,6
"2011","N00004519 (South ward)","N00004519",118,27,10,17,0,60,55,5,27,27,0,4
"2011","N00004520 (South ward)","N00004520",366,256,57,199,3,9,7,2,94,92,2,4
"2011","N00004521 (South ward)","N00004521",133,57,36,21,0,61,36,25,10,9,1,5
"2011","N00004522 (South ward)","N00004522",115,90,33,57,6,4,3,1,14,12,2,1
"2011","N00004523 (South ward)","N00004523",129,111,52,59,0,6,6,0,12,12,0,0
"2011","N00004524 (South ward)","N00004524",111,37,21,16,1,41,41,0,24,23,1,8
"2011","N00004525 (South ward)","N00004525",139,122,62,60,1,3,2,1,10,6,4,3
"2011","N00004526 (Victoria Bridge ward)","N00004526",142,125,93,32,0,1,1,0,11,8,3,5
"2011","N00004527 (Victoria Bridge ward)","N00004527",125,81,46,35,0,27,16,11,9,9,0,8
"2011","N00004528 (Victoria Bridge ward)","N00004528",147,120,71,49,0,4,3,1,16,12,4,7
"2011","N00004529 (Victoria Bridge ward)","N00004529",106,90,57,33,0,4,2,2,7,5,2,5
"2011","N00004530 (Victoria Bridge ward)","N00004530",133,97,54,43,1,13,11,2,15,11,4,7
"2011","N00004531 (Victoria Bridge ward)","N00004531",151,91,50,41,1,33,23,10,20,19,1,6
"2011","N00004532 (West ward)","N00004532",138,107,44,63,1,3,3,0,26,22,4,1
"2011","N00004533 (West ward)","N00004533",116,61,19,42,0,41,37,4,13,13,0,1
"2011","N00004534 (West ward)","N00004534",410,272,65,207,1,20,19,1,115,111,4,2
"2011","N00004535 (West ward)","N00004535",319,234,116,118,1,31,30,1,38,33,5,15
"2011","N00004536 (West ward)","N00004536",124,70,53,17,0,39,18,21,11,10,1,4
"2011","N00004537 (West ward)","N00004537",121,48,26,22,1,57,57,0,11,11,0,4
"2011","N00002912 (Ballinamallard ward)","N00002912",134,121,84,37,0,1,1,0,7,5,2,5
"2011","N00002913 (Ballinamallard ward)","N00002913",127,106,65,41,2,1,1,0,12,11,1,6
"2011","N00002914 (Ballinamallard ward)","N00002914",441,338,170,168,2,33,33,0,58,51,7,10
"2011","N00002915 (Ballinamallard ward)","N00002915",96,75,52,23,0,5,5,0,11,9,2,5
"2011","N00002916 (Ballinamallard ward)","N00002916",152,136,75,61,0,0,0,0,15,13,2,1
"2011","N00002917 (Belcoo and Garrison ward)","N00002917",127,106,83,23,1,1,1,0,14,12,2,5
"2011","N00002918 (Belcoo and Garrison ward)","N00002918",127,103,80,23,0,5,2,3,10,8,2,9
"2011","N00002919 (Belcoo and Garrison ward)","N00002919",131,106,64,42,0,7,6,1,13,12,1,5
"2011","N00002920 (Belcoo and Garrison ward)","N00002920",151,95,55,40,1,22,16,6,27,23,4,6
"2011","N00002921 (Belcoo and Garrison ward)","N00002921",110,101,74,27,0,4,4,0,3,2,1,2
"2011","N00002922 (Belcoo and Garrison ward)","N00002922",149,120,81,39,0,1,0,1,26,25,1,2
"2011","N00002923 (Belcoo and Garrison ward)","N00002923",138,98,74,24,0,19,19,0,16,14,2,5
"2011","N00002924 (Belleek and Boa ward)","N00002924",158,96,55,41,1,29,23,6,28,27,1,4
"2011","N00002925 (Belleek and Boa ward)","N00002925",119,97,65,32,0,3,2,1,16,15,1,3
"2011","N00002926 (Belleek and Boa ward)","N00002926",156,81,42,39,0,47,27,20,23,23,0,5
"2011","N00002927 (Belleek and Boa ward)","N00002927",141,120,85,35,2,1,1,0,13,12,1,5
"2011","N00002928 (Belleek and Boa ward)","N00002928",123,108,77,31,0,0,0,0,9,5,4,6
"2011","N00002929 (Belleek and Boa ward)","N00002929",274,225,154,71,0,4,4,0,33,28,5,12
"2011","N00002930 (Boho Cleenish and Letterbreen ward)","N00002930",143,124,75,49,0,2,2,0,15,12,3,2
"2011","N00002931 (Boho Cleenish and Letterbreen ward)","N00002931",225,170,75,95,5,4,3,1,38,34,4,8
"2011","N00002932 (Boho Cleenish and Letterbreen ward)","N00002932",127,107,60,47,0,0,0,0,12,11,1,8
"2011","N00002933 (Boho Cleenish and Letterbreen ward)","N00002933",171,148,102,46,0,1,1,0,20,17,3,2
"2011","N00002934 (Boho Cleenish and Letterbreen ward)","N00002934",132,111,75,36,0,1,1,0,16,16,0,4
"2011","N00002935 (Boho Cleenish and Letterbreen ward)","N00002935",140,123,80,43,0,4,1,3,9,9,0,4
"2011","N00002936 (Boho Cleenish and Letterbreen ward)","N00002936",143,116,86,30,0,5,5,0,11,11,0,11
"2011","N00002937 (Brookeborough ward)","N00002937",148,117,72,45,0,16,16,0,13,11,2,2
"2011","N00002938 (Brookeborough ward)","N00002938",137,126,85,41,0,2,2,0,3,2,1,6
"2011","N00002939 (Brookeborough ward)","N00002939",143,126,83,43,0,1,1,0,8,8,0,8
"2011","N00002940 (Brookeborough ward)","N00002940",140,126,84,42,0,1,1,0,12,10,2,1
"2011","N00002941 (Brookeborough ward)","N00002941",120,82,49,33,0,14,14,0,19,16,3,5
"2011","N00002942 (Brookeborough ward)","N00002942",134,116,67,49,0,1,1,0,14,10,4,3
"2011","N00002943 (Castlecoole ward)","N00002943",116,78,31,47,2,3,2,1,32,31,1,1
"2011","N00002944 (Castlecoole ward)","N00002944",216,118,29,89,0,18,5,13,78,72,6,2
"2011","N00002945 (Castlecoole ward)","N00002945",162,109,62,47,2,20,16,4,29,27,2,2
"2011","N00002946 (Castlecoole ward)","N00002946",130,57,26,31,0,54,52,2,16,16,0,3
"2011","N00002947 (Castlecoole ward)","N00002947",156,64,20,44,0,58,26,32,33,31,2,1
"2011","N00002948 (Castlecoole ward)","N00002948",124,108,46,62,1,3,2,1,12,10,2,0
"2011","N00002949 (Castlecoole ward)","N00002949",145,98,46,52,1,19,1,18,22,21,1,5
"2011","N00002950 (Castlecoole ward)","N00002950",148,107,66,41,0,1,0,1,36,36,0,4
"2011","N00002951 (Castlecoole ward)","N00002951",112,70,43,27,0,22,22,0,19,19,0,1
"2011","N00002952 (Castlecoole ward)","N00002952",129,105,70,35,0,2,2,0,19,17,2,3
"2011","N00002953 (Castlecoole ward)","N00002953",116,58,38,20,2,15,14,1,35,35,0,6
"2011","N00002954 (Derrygonnelly ward)","N00002954",196,156,92,64,0,0,0,0,38,33,5,2
"2011","N00002955 (Derrygonnelly ward)","N00002955",157,134,88,46,0,1,1,0,19,17,2,3
"2011","N00002956 (Derrygonnelly ward)","N00002956",131,99,64,35,0,4,4,0,25,22,3,3
"2011","N00002957 (Derrygonnelly ward)","N00002957",157,87,41,46,1,48,43,5,17,12,5,4
"2011","N00002958 (Derrygonnelly ward)","N00002958",156,138,86,52,0,0,0,0,14,12,2,4
"2011","N00002959 (Derrygonnelly ward)","N00002959",190,155,70,85,0,1,1,0,29,25,4,5
"2011","N00002960 (Derrylin ward)","N00002960",126,115,84,31,0,1,1,0,10,10,0,0
"2011","N00002961 (Derrylin ward)","N00002961",119,105,70,35,0,0,0,0,10,10,0,4
"2011","N00002962 (Derrylin ward)","N00002962",156,80,36,44,3,34,28,6,26,25,1,13
"2011","N00002963 (Derrylin ward)","N00002963",133,102,72,30,0,1,0,1,27,23,4,3
"2011","N00002964 (Derrylin ward)","N00002964",120,99,63,36,0,1,1,0,14,11,3,6
"2011","N00002965 (Derrylin ward)","N00002965",120,111,81,30,0,0,0,0,7,7,0,2
"2011","N00002966 (Derrylin ward)","N00002966",186,157,88,69,0,0,0,0,26,25,1,3
"2011","N00002967 (Devenish ward)","N00002967",116,61,33,28,1,32,32,0,20,17,3,2
"2011","N00002968 (Devenish ward)","N00002968",121,71,48,23,1,17,17,0,28,22,6,4
"2011","N00002969 (Devenish ward)","N00002969",118,66,43,23,2,24,24,0,16,16,0,10
"2011","N00002970 (Devenish ward)","N00002970",151,84,58,26,1,36,36,0,23,19,4,7
"2011","N00002971 (Devenish ward)","N00002971",128,57,34,23,2,26,23,3,36,32,4,7
"2011","N00002972 (Devenish ward)","N00002972",123,35,16,19,0,72,72,0,12,10,2,4
"2011","N00002973 (Donagh ward)","N00002973",133,120,75,45,0,1,1,0,6,6,0,6
"2011","N00002974 (Donagh ward)","N00002974",103,94,50,44,0,1,1,0,6,3,3,2
"2011","N00002975 (Donagh ward)","N00002975",164,140,85,55,0,3,1,2,17,15,2,4
"2011","N00002976 (Donagh ward)","N00002976",110,83,53,30,0,12,12,0,9,8,1,6
"2011","N00002977 (Donagh ward)","N00002977",152,123,78,45,1,4,4,0,18,16,2,6
"2011","N00002978 (Donagh ward)","N00002978",136,120,60,60,0,8,0,8,6,3,3,2
"2011","N00002979 (Erne ward)","N00002979",170,93,46,47,1,48,48,0,22,20,2,6
"2011","N00002980 (Erne ward)","N00002980",139,106,65,41,0,2,2,0,24,23,1,7
"2011","N00002981 (Erne ward)","N00002981",130,87,59,28,1,17,16,1,24,23,1,1
"2011","N00002982 (Erne ward)","N00002982",194,123,57,66,2,30,23,7,36,35,1,3
"2011","N00002983 (Erne ward)","N00002983",112,82,42,40,1,7,5,2,21,16,5,1
"2011","N00002984 (Erne ward)","N00002984",79,20,6,14,1,47,39,8,8,8,0,3
"2011","N00002985 (Erne ward)","N00002985",59,25,12,13,0,24,24,0,7,7,0,3
"2011","N00002986 (Erne ward)","N00002986",157,95,45,50,0,35,32,3,22,20,2,5
"2011","N00002987 (Florencecourt and Kinawley ward)","N00002987",155,113,63,50,0,5,5,0,33,27,6,4
"2011","N00002988 (Florencecourt and Kinawley ward)","N00002988",158,146,104,42,0,1,1,0,8,7,1,3
"2011","N00002989 (Florencecourt and Kinawley ward)","N00002989",157,128,74,54,0,7,3,4,18,15,3,4
"2011","N00002990 (Florencecourt and Kinawley ward)","N00002990",133,118,79,39,0,1,0,1,12,10,2,2
"2011","N00002991 (Florencecourt and Kinawley ward)","N00002991",135,102,63,39,1,13,6,7,16,15,1,3
"2011","N00002992 (Florencecourt and Kinawley ward)","N00002992",153,141,86,55,0,1,0,1,8,7,1,3
"2011","N00002993 (Irvinestown ward)","N00002993",104,35,15,20,0,46,45,1,20,19,1,3
"2011","N00002994 (Irvinestown ward)","N00002994",222,165,79,86,1,9,8,1,42,38,4,5
"2011","N00002995 (Irvinestown ward)","N00002995",248,186,92,94,0,7,6,1,49,44,5,6
"2011","N00002996 (Irvinestown ward)","N00002996",137,35,14,21,0,70,29,41,20,18,2,12
"2011","N00002997 (Irvinestown ward)","N00002997",123,77,42,35,2,18,18,0,17,12,5,9
"2011","N00002998 (Irvinestown ward)","N00002998",110,75,33,42,2,6,4,2,22,19,3,5
"2011","N00002999 (Irvinestown ward)","N00002999",116,55,34,21,0,29,28,1,29,27,2,3
"2011","N00003000 (Kesh Ederney and Lack ward)","N00003000",154,132,77,55,1,5,4,1,13,11,2,3
"2011","N00003001 (Kesh Ederney and Lack ward)","N00003001",99,69,38,31,1,4,4,0,19,14,5,6
"2011","N00003002 (Kesh Ederney and Lack ward)","N00003002",303,198,120,78,0,44,31,13,45,36,9,16
"2011","N00003003 (Kesh Ederney and Lack ward)","N00003003",525,398,215,183,0,36,33,3,77,70,7,14
"2011","N00003004 (Kesh Ederney and Lack ward)","N00003004",111,64,39,25,1,20,19,1,24,21,3,2
"2011","N00003005 (Kesh Ederney and Lack ward)","N00003005",155,135,83,52,1,1,0,1,14,12,2,4
"2011","N00003006 (Lisbellaw ward)","N00003006",133,117,61,56,0,1,1,0,10,9,1,5
"2011","N00003007 (Lisbellaw ward)","N00003007",149,119,63,56,0,1,1,0,17,14,3,12
"2011","N00003008 (Lisbellaw ward)","N00003008",235,189,105,84,0,10,10,0,31,27,4,5
"2011","N00003009 (Lisbellaw ward)","N00003009",164,142,76,66,0,0,0,0,19,18,1,3
"2011","N00003010 (Lisbellaw ward)","N00003010",161,111,48,63,1,11,11,0,36,31,5,2
"2011","N00003011 (Lisbellaw ward)","N00003011",114,82,37,45,1,18,11,7,9,9,0,4
"2011","N00003012 (Lisbellaw ward)","N00003012",133,107,55,52,0,2,1,1,20,20,0,4
"2011","N00003013 (Lisnarrick ward)","N00003013",148,118,78,40,0,1,1,0,27,20,7,2
"2011","N00003014 (Lisnarrick ward)","N00003014",142,130,87,43,0,1,1,0,9,4,5,2
"2011","N00003015 (Lisnarrick ward)","N00003015",147,130,82,48,0,1,1,0,13,12,1,3
"2011","N00003016 (Lisnarrick ward)","N00003016",113,102,71,31,0,1,1,0,7,5,2,3
"2011","N00003017 (Lisnarrick ward)","N00003017",155,135,91,44,1,5,5,0,11,11,0,3
"2011","N00003018 (Lisnaskea ward)","N00003018",108,66,40,26,0,5,5,0,28,26,2,9
"2011","N00003019 (Lisnaskea ward)","N00003019",215,93,46,47,1,75,75,0,36,32,4,10
"2011","N00003020 (Lisnaskea ward)","N00003020",148,84,37,47,0,17,16,1,38,30,8,9
"2011","N00003021 (Lisnaskea ward)","N00003021",143,80,32,48,2,3,2,1,56,49,7,2
"2011","N00003022 (Lisnaskea ward)","N00003022",119,84,63,21,0,4,4,0,27,24,3,4
"2011","N00003023 (Lisnaskea ward)","N00003023",109,39,18,21,0,44,44,0,16,16,0,10
"2011","N00003024 (Lisnaskea ward)","N00003024",186,137,86,51,0,11,11,0,32,27,5,6
"2011","N00003025 (Maguiresbridge ward)","N00003025",121,87,30,57,0,6,4,2,24,18,6,4
"2011","N00003026 (Maguiresbridge ward)","N00003026",180,147,75,72,0,3,3,0,28,27,1,2
"2011","N00003027 (Maguiresbridge ward)","N00003027",140,123,75,48,0,0,0,0,14,13,1,3
"2011","N00003028 (Maguiresbridge ward)","N00003028",153,142,90,52,0,0,0,0,5,4,1,6
"2011","N00003029 (Maguiresbridge ward)","N00003029",193,142,73,69,1,0,0,0,43,37,6,7
"2011","N00003030 (Maguiresbridge ward)","N00003030",150,81,42,39,1,33,29,4,25,24,1,10
"2011","N00003031 (Maguiresbridge ward)","N00003031",156,139,77,62,0,2,2,0,11,9,2,4
"2011","N00003032 (Newtownbutler ward)","N00003032",117,106,72,34,1,1,1,0,6,5,1,3
"2011","N00003033 (Newtownbutler ward)","N00003033",155,125,72,53,0,8,2,6,17,10,7,5
"2011","N00003034 (Newtownbutler ward)","N00003034",108,37,17,20,1,48,44,4,15,13,2,7
"2011","N00003035 (Newtownbutler ward)","N00003035",142,67,37,30,0,39,26,13,25,21,4,11
"2011","N00003036 (Newtownbutler ward)","N00003036",137,85,56,29,0,12,9,3,34,27,7,6
"2011","N00003037 (Newtownbutler ward)","N00003037",147,91,56,35,0,27,23,4,24,21,3,5
"2011","N00003038 (Newtownbutler ward)","N00003038",127,101,67,34,0,6,5,1,14,13,1,6
"2011","N00003039 (Portora ward)","N00003039",134,64,42,22,0,33,7,26,28,23,5,9
"2011","N00003040 (Portora ward)","N00003040",256,68,42,26,0,76,21,55,94,88,6,18
"2011","N00003041 (Portora ward)","N00003041",180,98,53,45,0,19,19,0,58,51,7,5
"2011","N00003042 (Portora ward)","N00003042",129,57,37,20,1,36,36,0,28,26,2,7
"2011","N00003043 (Portora ward)","N00003043",97,50,27,23,0,28,25,3,11,10,1,8
"2011","N00003044 (Portora ward)","N00003044",158,125,84,41,1,9,8,1,21,17,4,2
"2011","N00003045 (Portora ward)","N00003045",306,198,94,104,1,3,2,1,98,96,2,6
"2011","N00003046 (Portora ward)","N00003046",119,93,35,58,0,2,2,0,22,20,2,2
"2011","N00003047 (Rosslea ward)","N00003047",133,117,83,34,0,0,0,0,13,10,3,3
"2011","N00003048 (Rosslea ward)","N00003048",147,121,88,33,0,6,5,1,10,8,2,10
"2011","N00003049 (Rosslea ward)","N00003049",131,83,51,32,1,22,21,1,19,16,3,6
"2011","N00003050 (Rosslea ward)","N00003050",123,103,73,30,1,2,2,0,8,8,0,9
"2011","N00003051 (Rosslea ward)","N00003051",124,118,83,35,0,0,0,0,4,2,2,2
"2011","N00003052 (Rosslea ward)","N00003052",125,53,22,31,0,43,32,11,26,23,3,3
"2011","N00003053 (Rossorry ward)","N00003053",102,79,56,23,0,0,0,0,21,20,1,2
"2011","N00003054 (Rossorry ward)","N00003054",137,118,72,46,0,1,1,0,12,11,1,6
"2011","N00003055 (Rossorry ward)","N00003055",135,109,51,58,1,6,6,0,19,18,1,0
"2011","N00003056 (Rossorry ward)","N00003056",133,115,70,45,2,1,1,0,14,12,2,1
"2011","N00003057 (Rossorry ward)","N00003057",118,53,24,29,0,46,46,0,12,12,0,7
"2011","N00003058 (Rossorry ward)","N00003058",116,81,42,39,0,25,25,0,10,9,1,0
"2011","N00003059 (Rossorry ward)","N00003059",114,95,44,51,0,0,0,0,14,12,2,5
"2011","N00003060 (Rossorry ward)","N00003060",155,65,43,22,1,58,29,29,24,20,4,7
"2011","N00003061 (Tempo ward)","N00003061",136,128,89,39,0,2,2,0,5,3,2,1
"2011","N00003062 (Tempo ward)","N00003062",147,135,81,54,0,1,1,0,9,9,0,2
"2011","N00003063 (Tempo ward)","N00003063",173,148,110,38,0,3,2,1,18,16,2,4
"2011","N00003064 (Tempo ward)","N00003064",157,127,66,61,0,2,2,0,18,17,1,10
"2011","N00003065 (Tempo ward)","N00003065",138,71,38,33,0,39,37,2,20,20,0,8
"2011","N00003066 (Tempo ward)","N00003066",147,112,77,35,0,1,1,0,34,33,1,0
"2011","N00004338 (Beragh ward)","N00004338",120,104,62,42,0,7,7,0,8,7,1,1
"2011","N00004339 (Beragh ward)","N00004339",178,149,81,68,0,1,0,1,22,20,2,6
"2011","N00004340 (Beragh ward)","N00004340",145,129,78,51,0,3,2,1,9,8,1,4
"2011","N00004341 (Beragh ward)","N00004341",146,121,65,56,0,2,2,0,18,16,2,5
"2011","N00004342 (Beragh ward)","N00004342",272,148,86,62,1,33,33,0,80,70,10,10
"2011","N00004343 (Camowen ward)","N00004343",100,71,25,46,3,6,5,1,19,16,3,1
"2011","N00004344 (Camowen ward)","N00004344",112,78,51,27,1,14,14,0,17,15,2,2
"2011","N00004345 (Camowen ward)","N00004345",143,101,58,43,0,4,4,0,35,31,4,3
"2011","N00004346 (Camowen ward)","N00004346",148,78,39,39,0,50,43,7,17,17,0,3
"2011","N00004347 (Camowen ward)","N00004347",159,117,65,52,1,4,4,0,34,27,7,3
"2011","N00004348 (Camowen ward)","N00004348",107,46,28,18,0,40,40,0,17,17,0,4
"2011","N00004349 (Camowen ward)","N00004349",114,34,14,20,0,45,45,0,19,17,2,16
"2011","N00004350 (Clanabogan ward)","N00004350",369,309,164,145,0,11,11,0,45,40,5,4
"2011","N00004351 (Clanabogan ward)","N00004351",157,141,68,73,0,0,0,0,13,11,2,3
"2011","N00004352 (Clanabogan ward)","N00004352",181,160,82,78,0,3,3,0,13,10,3,5
"2011","N00004353 (Clanabogan ward)","N00004353",152,129,72,57,0,0,0,0,21,17,4,2
"2011","N00004354 (Clanabogan ward)","N00004354",132,106,61,45,0,1,1,0,15,15,0,10
"2011","N00004355 (Coolnagard ward)","N00004355",148,114,71,43,2,0,0,0,30,26,4,2
"2011","N00004356 (Coolnagard ward)","N00004356",115,59,36,23,0,29,29,0,22,21,1,5
"2011","N00004357 (Coolnagard ward)","N00004357",520,350,147,203,3,45,39,6,113,105,8,9
"2011","N00004358 (Coolnagard ward)","N00004358",123,71,38,33,2,27,21,6,19,13,6,4
"2011","N00004359 (Coolnagard ward)","N00004359",364,213,56,157,1,24,22,2,121,117,4,5
"2011","N00004360 (Dergmoney ward)","N00004360",211,170,123,47,2,8,7,1,23,21,2,8
"2011","N00004361 (Dergmoney ward)","N00004361",272,106,76,30,0,62,61,1,88,83,5,16
"2011","N00004362 (Dergmoney ward)","N00004362",262,200,109,91,9,7,6,1,44,40,4,2
"2011","N00004363 (Dromore ward)","N00004363",148,122,69,53,0,5,4,1,14,13,1,7
"2011","N00004364 (Dromore ward)","N00004364",135,114,74,40,0,3,2,1,13,9,4,5
"2011","N00004365 (Dromore ward)","N00004365",185,102,43,59,0,25,15,10,50,45,5,8
"2011","N00004366 (Dromore ward)","N00004366",123,46,23,23,0,49,42,7,21,17,4,7
"2011","N00004367 (Dromore ward)","N00004367",267,180,117,63,0,23,22,1,46,39,7,18
"2011","N00004368 (Drumnakilly ward)","N00004368",155,140,69,71,0,0,0,0,13,12,1,2
"2011","N00004369 (Drumnakilly ward)","N00004369",129,99,64,35,0,17,17,0,11,8,3,2
"2011","N00004370 (Drumnakilly ward)","N00004370",190,123,65,58,1,14,14,0,43,40,3,9
"2011","N00004371 (Drumnakilly ward)","N00004371",144,131,90,41,0,0,0,0,9,6,3,4
"2011","N00004372 (Drumnakilly ward)","N00004372",140,127,73,54,0,1,1,0,8,7,1,4
"2011","N00004373 (Drumnakilly ward)","N00004373",154,131,58,73,1,1,1,0,15,13,2,6
"2011","N00004374 (Drumquin ward)","N00004374",150,136,87,49,0,3,3,0,9,8,1,2
"2011","N00004375 (Drumquin ward)","N00004375",338,196,103,93,1,66,64,2,65,55,10,10
"2011","N00004376 (Drumquin ward)","N00004376",145,127,82,45,0,1,1,0,15,10,5,2
"2011","N00004377 (Drumquin ward)","N00004377",156,132,76,56,0,2,1,1,17,12,5,5
"2011","N00004378 (Drumragh ward)","N00004378",119,28,19,9,1,1,1,0,87,83,4,2
"2011","N00004379 (Drumragh ward)","N00004379",117,88,58,30,0,9,9,0,18,17,1,2
"2011","N00004380 (Drumragh ward)","N00004380",121,101,63,38,0,3,3,0,15,13,2,2
"2011","N00004381 (Drumragh ward)","N00004381",129,94,52,42,1,2,2,0,30,30,0,2
"2011","N00004382 (Drumragh ward)","N00004382",176,77,47,30,2,45,20,25,49,48,1,3
"2011","N00004383 (Drumragh ward)","N00004383",138,86,51,35,0,27,27,0,18,16,2,7
"2011","N00004384 (Drumragh ward)","N00004384",116,77,54,23,0,9,8,1,24,23,1,6
"2011","N00004385 (Drumragh ward)","N00004385",98,85,56,29,0,1,1,0,6,5,1,6
"2011","N00004386 (Fairy Water ward)","N00004386",139,126,77,49,0,1,1,0,10,7,3,2
"2011","N00004387 (Fairy Water ward)","N00004387",134,118,74,44,0,3,3,0,7,7,0,6
"2011","N00004388 (Fairy Water ward)","N00004388",144,129,86,43,0,4,4,0,8,8,0,3
"2011","N00004389 (Fairy Water ward)","N00004389",145,134,84,50,0,1,1,0,6,5,1,4
"2011","N00004390 (Fairy Water ward)","N00004390",143,125,87,38,0,4,2,2,12,10,2,2
"2011","N00004391 (Fintona ward)","N00004391",157,139,81,58,0,4,4,0,10,8,2,4
"2011","N00004392 (Fintona ward)","N00004392",136,68,43,25,1,34,33,1,23,21,2,10
"2011","N00004393 (Fintona ward)","N00004393",143,79,55,24,0,35,32,3,21,19,2,8
"2011","N00004394 (Fintona ward)","N00004394",106,45,29,16,0,31,31,0,27,27,0,3
"2011","N00004395 (Fintona ward)","N00004395",122,56,40,16,0,32,32,0,22,20,2,12
"2011","N00004396 (Fintona ward)","N00004396",156,136,77,59,0,2,2,0,13,11,2,5
"2011","N00004397 (Gortin ward)","N00004397",145,89,52,37,0,17,17,0,32,27,5,7
"2011","N00004398 (Gortin ward)","N00004398",173,144,79,65,1,1,1,0,23,22,1,4
"2011","N00004399 (Gortin ward)","N00004399",178,165,87,78,0,2,2,0,9,9,0,2
"2011","N00004400 (Gortin ward)","N00004400",168,137,78,59,1,7,7,0,15,10,5,8
"2011","N00004401 (Gortin ward)","N00004401",268,170,83,87,1,8,8,0,87,85,2,2
"2011","N00004402 (Gortrush ward)","N00004402",423,245,94,151,1,59,43,16,109,101,8,9
"2011","N00004403 (Gortrush ward)","N00004403",119,74,24,50,1,2,1,1,42,39,3,0
"2011","N00004404 (Gortrush ward)","N00004404",293,138,76,62,0,81,54,27,63,53,10,11
"2011","N00004405 (Gortrush ward)","N00004405",283,142,74,68,1,91,73,18,32,30,2,17
"2011","N00004406 (Killyclogher ward)","N00004406",169,61,13,48,1,70,69,1,29,29,0,8
"2011","N00004407 (Killyclogher ward)","N00004407",120,89,36,53,2,3,3,0,24,24,0,2
"2011","N00004408 (Killyclogher ward)","N00004408",125,92,36,56,2,4,4,0,26,22,4,1
"2011","N00004409 (Killyclogher ward)","N00004409",145,119,56,63,0,2,2,0,22,19,3,2
"2011","N00004410 (Killyclogher ward)","N00004410",255,163,70,93,0,16,16,0,69,61,8,7
"2011","N00004411 (Killyclogher ward)","N00004411",171,117,38,79,3,2,2,0,49,46,3,0
"2011","N00004412 (Killyclogher ward)","N00004412",162,87,31,56,1,16,16,0,50,47,3,8
"2011","N00004413 (Lisanelly ward)","N00004413",121,65,48,17,1,38,7,31,15,13,2,2
"2011","N00004414 (Lisanelly ward)","N00004414",79,52,42,10,1,2,0,2,23,22,1,1
"2011","N00004415 (Lisanelly ward)","N00004415",447,129,28,101,0,205,203,2,82,75,7,31
"2011","N00004416 (Lisanelly ward)","N00004416",242,99,50,49,0,77,76,1,58,55,3,8
"2011","N00004417 (Newtownsaville ward)","N00004417",166,137,86,51,1,2,2,0,22,19,3,4
"2011","N00004418 (Newtownsaville ward)","N00004418",170,138,92,46,0,0,0,0,28,21,7,4
"2011","N00004419 (Newtownsaville ward)","N00004419",153,129,71,58,0,3,3,0,20,20,0,1
"2011","N00004420 (Newtownsaville ward)","N00004420",168,149,91,58,0,3,2,1,10,7,3,6
"2011","N00004421 (Newtownsaville ward)","N00004421",141,107,71,36,1,3,3,0,23,20,3,7
"2011","N00004422 (Owenkillew ward)","N00004422",156,137,89,48,0,1,1,0,11,6,5,7
"2011","N00004423 (Owenkillew ward)","N00004423",136,125,83,42,0,1,1,0,8,5,3,2
"2011","N00004424 (Owenkillew ward)","N00004424",143,107,65,42,0,20,19,1,12,11,1,4
"2011","N00004425 (Owenkillew ward)","N00004425",161,118,53,65,0,8,8,0,31,28,3,4
"2011","N00004426 (Owenkillew ward)","N00004426",150,121,71,50,0,9,4,5,12,8,4,8
"2011","N00004427 (Sixmilecross ward)","N00004427",145,92,66,26,0,13,4,9,37,30,7,3
"2011","N00004428 (Sixmilecross ward)","N00004428",134,115,85,30,0,2,2,0,10,7,3,7
"2011","N00004429 (Sixmilecross ward)","N00004429",158,143,81,62,0,0,0,0,12,10,2,3
"2011","N00004430 (Sixmilecross ward)","N00004430",152,121,78,43,0,13,6,7,16,14,2,2
"2011","N00004431 (Sixmilecross ward)","N00004431",157,134,78,56,0,3,0,3,15,12,3,5
"2011","N00004432 (Strule ward)","N00004432",97,22,18,4,0,35,10,25,36,36,0,4
"2011","N00004433 (Strule ward)","N00004433",262,153,105,48,0,32,31,1,66,60,6,11
"2011","N00004434 (Strule ward)","N00004434",210,111,71,40,1,20,19,1,72,67,5,6
"2011","N00004435 (Strule ward)","N00004435",138,88,51,37,0,5,5,0,44,41,3,1
"2011","N00004436 (Termon ward)","N00004436",124,103,68,35,0,1,0,1,18,17,1,2
"2011","N00004437 (Termon ward)","N00004437",118,81,42,39,0,20,15,5,14,8,6,3
"2011","N00004438 (Termon ward)","N00004438",157,138,89,49,0,4,3,1,11,10,1,4
"2011","N00004439 (Termon ward)","N00004439",176,153,107,46,0,1,1,0,15,11,4,7
"2011","N00004440 (Termon ward)","N00004440",146,133,73,60,1,2,2,0,7,6,1,3
"2011","N00004441 (Trillick ward)","N00004441",173,150,86,64,0,1,1,0,17,15,2,5
"2011","N00004442 (Trillick ward)","N00004442",162,148,100,48,0,1,1,0,7,6,1,6
"2011","N00004443 (Trillick ward)","N00004443",185,168,104,64,0,0,0,0,13,9,4,4
"2011","N00004444 (Trillick ward)","N00004444",131,73,45,28,2,21,21,0,32,26,6,3
"2011","N00004445 (Trillick ward)","N00004445",140,113,78,35,0,2,2,0,21,14,7,4
"2011","N00001750 (Ballyhanwood ward)","N00001750",115,101,42,59,0,1,1,0,11,10,1,2
"2011","N00001751 (Ballyhanwood ward)","N00001751",116,106,49,57,0,2,2,0,7,6,1,1
"2011","N00001752 (Ballyhanwood ward)","N00001752",128,117,81,36,0,1,1,0,8,5,3,2
"2011","N00001753 (Ballyhanwood ward)","N00001753",137,83,25,58,0,45,45,0,8,6,2,1
"2011","N00001754 (Ballyhanwood ward)","N00001754",130,110,44,66,0,3,2,1,16,15,1,1
"2011","N00001755 (Ballyhanwood ward)","N00001755",131,127,72,55,0,0,0,0,2,2,0,2
"2011","N00001756 (Ballyhanwood ward)","N00001756",131,125,71,54,0,2,1,1,3,3,0,1
"2011","N00001757 (Ballyhanwood ward)","N00001757",119,94,34,60,2,2,2,0,18,17,1,3
"2011","N00001758 (Ballyhanwood ward)","N00001758",132,128,85,43,0,0,0,0,3,2,1,1
"2011","N00001760 (Beechill ward)","N00001760",389,332,105,227,1,19,2,17,28,24,4,9
"2011","N00001761 (Beechill ward)","N00001761",118,110,40,70,0,4,3,1,3,3,0,1
"2011","N00001763 (Beechill ward)","N00001763",545,409,166,243,1,85,31,54,41,37,4,9
"2011","N00001767 (Cairnshill ward)","N00001767",110,92,28,64,2,2,2,0,13,11,2,1
"2011","N00001768 (Cairnshill ward)","N00001768",114,102,32,70,1,2,2,0,8,7,1,1
"2011","N00001769 (Cairnshill ward)","N00001769",120,110,35,75,0,0,0,0,9,9,0,1
"2011","N00001770 (Cairnshill ward)","N00001770",89,87,23,64,0,0,0,0,2,1,1,0
"2011","N00001771 (Cairnshill ward)","N00001771",142,133,19,114,0,0,0,0,9,8,1,0
"2011","N00001772 (Cairnshill ward)","N00001772",118,110,65,45,0,0,0,0,7,5,2,1
"2011","N00001773 (Cairnshill ward)","N00001773",106,92,52,40,1,4,3,1,8,8,0,1
"2011","N00001774 (Cairnshill ward)","N00001774",128,105,36,69,2,2,2,0,17,15,2,2
"2011","N00001775 (Cairnshill ward)","N00001775",119,101,28,73,2,0,0,0,15,14,1,1
"2011","N00001776 (Cairnshill ward)","N00001776",122,102,27,75,2,1,1,0,17,14,3,0
"2011","N00001777 (Cairnshill ward)","N00001777",136,125,57,68,1,0,0,0,10,9,1,0
"2011","N00001778 (Carrowreagh ward)","N00001778",114,105,26,79,0,1,1,0,8,8,0,0
"2011","N00001779 (Carrowreagh ward)","N00001779",118,62,22,40,2,33,33,0,18,18,0,3
"2011","N00001780 (Carrowreagh ward)","N00001780",248,211,67,144,3,3,1,2,26,22,4,5
"2011","N00001781 (Carrowreagh ward)","N00001781",126,121,40,81,1,1,1,0,2,2,0,1
"2011","N00001782 (Carrowreagh ward)","N00001782",124,111,28,83,1,0,0,0,8,6,2,4
"2011","N00001783 (Carrowreagh ward)","N00001783",134,122,46,76,1,2,2,0,8,8,0,1
"2011","N00001784 (Carrowreagh ward)","N00001784",129,63,23,40,2,39,39,0,20,20,0,5
"2011","N00001785 (Carrowreagh ward)","N00001785",136,96,33,63,1,25,25,0,11,9,2,3
"2011","N00001786 (Carrowreagh ward)","N00001786",135,109,63,46,0,14,13,1,11,9,2,1
"2011","N00001787 (Carrowreagh ward)","N00001787",130,50,21,29,0,65,65,0,9,8,1,6
"2011","N00001788 (Carrowreagh ward)","N00001788",126,76,19,57,1,42,42,0,6,6,0,1
"2011","N00001789 (Carrowreagh ward)","N00001789",152,136,23,113,1,1,1,0,12,11,1,2
"2011","N00001790 (Carryduff East ward)","N00001790",132,119,61,58,1,0,0,0,11,9,2,1
"2011","N00001791 (Carryduff East ward)","N00001791",155,147,81,66,2,0,0,0,5,5,0,1
"2011","N00001792 (Carryduff East ward)","N00001792",97,91,33,58,0,1,0,1,5,5,0,0
"2011","N00001793 (Carryduff East ward)","N00001793",143,134,48,86,0,0,0,0,7,6,1,2
"2011","N00001794 (Carryduff East ward)","N00001794",374,236,100,136,7,90,57,33,30,25,5,11
"2011","N00001795 (Carryduff East ward)","N00001795",122,100,33,67,3,1,1,0,16,14,2,2
"2011","N00001796 (Carryduff East ward)","N00001796",130,107,36,71,2,1,1,0,18,14,4,2
"2011","N00001797 (Carryduff East ward)","N00001797",148,125,69,56,0,2,1,1,20,19,1,1
"2011","N00001798 (Carryduff West ward)","N00001798",147,132,33,99,1,2,2,0,11,8,3,1
"2011","N00001799 (Carryduff West ward)","N00001799",125,115,72,43,0,2,1,1,5,5,0,3
"2011","N00001800 (Carryduff West ward)","N00001800",128,126,54,72,1,0,0,0,1,1,0,0
"2011","N00001801 (Carryduff West ward)","N00001801",133,127,40,87,0,1,0,1,5,5,0,0
"2011","N00001802 (Carryduff West ward)","N00001802",126,102,21,81,6,1,1,0,16,16,0,1
"2011","N00001803 (Carryduff West ward)","N00001803",123,107,52,55,0,1,1,0,14,12,2,1
"2011","N00001804 (Carryduff West ward)","N00001804",135,123,64,59,0,1,1,0,11,11,0,0
"2011","N00001805 (Carryduff West ward)","N00001805",368,275,84,191,8,3,2,1,82,78,4,0
"2011","N00001820 (Dundonald ward)","N00001820",149,94,60,34,1,30,2,28,18,18,0,6
"2011","N00001821 (Dundonald ward)","N00001821",296,162,60,102,0,43,4,39,90,57,33,1
"2011","N00001822 (Dundonald ward)","N00001822",132,115,58,57,0,0,0,0,15,15,0,2
"2011","N00001823 (Dundonald ward)","N00001823",171,154,68,86,0,2,0,2,12,11,1,3
"2011","N00001824 (Dundonald ward)","N00001824",117,113,29,84,0,0,0,0,3,2,1,1
"2011","N00001825 (Dundonald ward)","N00001825",103,84,38,46,4,2,2,0,11,11,0,2
"2011","N00001826 (Dundonald ward)","N00001826",120,114,25,89,0,0,0,0,5,5,0,1
"2011","N00001827 (Dundonald ward)","N00001827",118,109,48,61,0,2,1,1,7,7,0,0
"2011","N00001828 (Dundonald ward)","N00001828",107,68,19,49,1,12,1,11,25,23,2,1
"2011","N00001829 (Dundonald ward)","N00001829",104,82,37,45,0,4,0,4,17,16,1,1
"2011","N00001830 (Enler ward)","N00001830",146,54,7,47,2,83,81,2,5,5,0,2
"2011","N00001831 (Enler ward)","N00001831",117,106,32,74,0,7,6,1,4,4,0,0
"2011","N00001832 (Enler ward)","N00001832",113,65,29,36,2,39,39,0,5,5,0,2
"2011","N00001833 (Enler ward)","N00001833",167,82,25,57,7,40,39,1,32,31,1,6
"2011","N00001834 (Enler ward)","N00001834",105,72,42,30,1,22,22,0,6,3,3,4
"2011","N00001835 (Enler ward)","N00001835",128,72,31,41,1,43,42,1,5,4,1,7
"2011","N00001836 (Enler ward)","N00001836",122,67,22,45,1,44,38,6,5,4,1,5
"2011","N00001837 (Enler ward)","N00001837",119,62,31,31,3,47,46,1,3,3,0,4
"2011","N00001838 (Enler ward)","N00001838",127,67,28,39,1,52,50,2,4,3,1,3
"2011","N00001839 (Galwally ward)","N00001839",168,125,71,54,0,23,3,20,19,16,3,1
"2011","N00001840 (Galwally ward)","N00001840",112,105,39,66,0,1,1,0,3,2,1,3
"2011","N00001841 (Galwally ward)","N00001841",142,123,42,81,0,2,1,1,16,15,1,1
"2011","N00001842 (Galwally ward)","N00001842",124,106,58,48,1,0,0,0,16,14,2,1
"2011","N00001843 (Galwally ward)","N00001843",134,112,47,65,2,2,2,0,15,14,1,3
"2011","N00001844 (Galwally ward)","N00001844",127,96,50,46,0,0,0,0,30,30,0,1
"2011","N00001845 (Galwally ward)","N00001845",123,105,71,34,0,0,0,0,18,18,0,0
"2011","N00001846 (Galwally ward)","N00001846",125,109,61,48,0,3,1,2,11,11,0,2
"2011","N00001854 (Grahams Bridge ward)","N00001854",127,32,12,20,2,79,79,0,6,5,1,8
"2011","N00001855 (Grahams Bridge ward)","N00001855",135,103,59,44,2,8,8,0,21,20,1,1
"2011","N00001856 (Grahams Bridge ward)","N00001856",117,73,27,46,0,25,23,2,17,14,3,2
"2011","N00001857 (Grahams Bridge ward)","N00001857",129,61,25,36,2,49,37,12,14,14,0,3
"2011","N00001858 (Grahams Bridge ward)","N00001858",110,65,31,34,1,30,29,1,12,11,1,2
"2011","N00001859 (Grahams Bridge ward)","N00001859",125,57,20,37,2,56,56,0,6,6,0,4
"2011","N00001860 (Grahams Bridge ward)","N00001860",112,50,31,19,1,46,45,1,11,9,2,4
"2011","N00001861 (Grahams Bridge ward)","N00001861",114,52,21,31,0,37,36,1,20,18,2,5
"2011","N00001862 (Grahams Bridge ward)","N00001862",146,101,49,52,0,8,8,0,34,32,2,3
"2011","N00001863 (Grahams Bridge ward)","N00001863",138,80,44,36,1,42,9,33,11,10,1,4
"2011","N00001871 (Knockbracken ward)","N00001871",138,120,34,86,0,2,2,0,15,14,1,1
"2011","N00001872 (Knockbracken ward)","N00001872",113,75,26,49,4,18,2,16,14,14,0,2
"2011","N00001873 (Knockbracken ward)","N00001873",280,233,50,183,0,6,4,2,39,38,1,2
"2011","N00001874 (Knockbracken ward)","N00001874",129,124,51,73,0,2,1,1,3,3,0,0
"2011","N00001875 (Knockbracken ward)","N00001875",134,124,78,46,0,1,0,1,6,5,1,3
"2011","N00001876 (Knockbracken ward)","N00001876",133,119,62,57,0,0,0,0,14,13,1,0
"2011","N00001877 (Knockbracken ward)","N00001877",128,122,84,38,0,1,1,0,3,3,0,2
"2011","N00001878 (Knockbracken ward)","N00001878",127,118,70,48,2,3,2,1,4,3,1,0
"2011","N00001879 (Knockbracken ward)","N00001879",137,121,64,57,0,0,0,0,15,15,0,1
"2011","N00001900 (Moneyreagh ward)","N00001900",129,114,78,36,0,1,1,0,10,8,2,4
"2011","N00001901 (Moneyreagh ward)","N00001901",134,122,76,46,0,3,3,0,7,2,5,2
"2011","N00001902 (Moneyreagh ward)","N00001902",142,135,81,54,0,2,0,2,2,2,0,3
"2011","N00001903 (Moneyreagh ward)","N00001903",125,112,41,71,0,0,0,0,10,10,0,3
"2011","N00001904 (Moneyreagh ward)","N00001904",103,76,30,46,2,15,15,0,6,4,2,4
"2011","N00001905 (Moneyreagh ward)","N00001905",113,90,50,40,0,11,11,0,6,6,0,6
"2011","N00001906 (Moneyreagh ward)","N00001906",126,112,75,37,0,1,1,0,8,7,1,5
"2011","N00001907 (Moneyreagh ward)","N00001907",135,122,59,63,1,3,3,0,7,7,0,2
"2011","N00001908 (Moneyreagh ward)","N00001908",144,99,37,62,1,31,31,0,7,7,0,6
"2011","N00001909 (Moneyreagh ward)","N00001909",119,102,40,62,0,4,4,0,11,11,0,2
"2011","N00001910 (Moneyreagh ward)","N00001910",119,117,51,66,0,2,2,0,0,0,0,0
"2011","N00001911 (Newtownbreda ward)","N00001911",120,65,26,39,2,31,29,2,19,18,1,3
"2011","N00001913 (Newtownbreda ward)","N00001913",124,114,55,59,0,1,1,0,9,8,1,0
"2011","N00001914 (Newtownbreda ward)","N00001914",129,107,40,67,0,1,0,1,20,19,1,1
"2011","N00001915 (Newtownbreda ward)","N00001915",281,228,97,131,5,0,0,0,46,42,4,2
"2011","N00001916 (Newtownbreda ward)","N00001916",124,95,52,43,0,6,2,4,21,21,0,2
"2011","N00001917 (Newtownbreda ward)","N00001917",121,93,45,48,0,5,5,0,21,19,2,2
"2011","N00001918 (Newtownbreda ward)","N00001918",113,100,51,49,0,2,0,2,11,10,1,0
"2011","N00003240 (Ballinderry ward)","N00003240",149,128,73,55,0,4,4,0,15,12,3,2
"2011","N00003241 (Ballinderry ward)","N00003241",129,115,70,45,0,2,2,0,8,8,0,4
"2011","N00003242 (Ballinderry ward)","N00003242",116,102,62,40,1,1,1,0,10,10,0,2
"2011","N00003243 (Ballinderry ward)","N00003243",150,139,79,60,0,3,3,0,5,5,0,3
"2011","N00003244 (Ballinderry ward)","N00003244",122,110,72,38,0,4,3,1,4,3,1,4
"2011","N00003245 (Ballinderry ward)","N00003245",164,152,77,75,0,0,0,0,7,7,0,5
"2011","N00003246 (Ballinderry ward)","N00003246",286,229,79,150,5,10,10,0,37,37,0,5
"2011","N00003247 (Ballinderry ward)","N00003247",280,242,72,170,1,10,2,8,24,21,3,3
"2011","N00003248 (Ballinderry ward)","N00003248",137,110,50,60,0,9,8,1,16,15,1,2
"2011","N00003249 (Ballinderry ward)","N00003249",148,127,28,99,1,5,5,0,12,12,0,3
"2011","N00003250 (Ballymacash ward)","N00003250",128,121,73,48,1,3,3,0,3,3,0,0
"2011","N00003251 (Ballymacash ward)","N00003251",116,108,56,52,0,1,1,0,7,6,1,0
"2011","N00003252 (Ballymacash ward)","N00003252",133,47,20,27,1,72,20,52,9,8,1,4
"2011","N00003253 (Ballymacash ward)","N00003253",123,94,47,47,0,10,9,1,14,13,1,5
"2011","N00003254 (Ballymacash ward)","N00003254",113,99,70,29,0,4,3,1,6,6,0,4
"2011","N00003255 (Ballymacash ward)","N00003255",111,74,30,44,0,34,7,27,3,2,1,0
"2011","N00003256 (Ballymacash ward)","N00003256",142,126,79,47,0,1,0,1,13,12,1,2
"2011","N00003257 (Ballymacash ward)","N00003257",112,109,47,62,0,0,0,0,2,1,1,1
"2011","N00003258 (Ballymacash ward)","N00003258",178,169,48,121,6,0,0,0,1,1,0,2
"2011","N00003259 (Ballymacash ward)","N00003259",121,118,62,56,0,0,0,0,1,1,0,2
"2011","N00003260 (Ballymacash ward)","N00003260",127,122,57,65,2,0,0,0,2,2,0,1
"2011","N00003261 (Ballymacash ward)","N00003261",126,123,28,95,1,0,0,0,1,1,0,1
"2011","N00003262 (Ballymacbrennan ward)","N00003262",137,126,73,53,0,1,1,0,5,5,0,5
"2011","N00003263 (Ballymacbrennan ward)","N00003263",135,106,65,41,0,2,2,0,20,18,2,7
"2011","N00003264 (Ballymacbrennan ward)","N00003264",140,127,71,56,0,0,0,0,10,10,0,3
"2011","N00003265 (Ballymacbrennan ward)","N00003265",135,124,79,45,0,1,1,0,4,3,1,6
"2011","N00003266 (Ballymacbrennan ward)","N00003266",132,121,83,38,0,3,2,1,6,5,1,2
"2011","N00003267 (Ballymacbrennan ward)","N00003267",135,133,75,58,0,0,0,0,1,0,1,1
"2011","N00003268 (Ballymacbrennan ward)","N00003268",119,109,62,47,0,1,1,0,5,5,0,4
"2011","N00003269 (Ballymacbrennan ward)","N00003269",129,109,64,45,0,4,4,0,13,9,4,3
"2011","N00003270 (Ballymacbrennan ward)","N00003270",127,116,74,42,0,3,2,1,7,6,1,1
"2011","N00003271 (Ballymacoss ward)","N00003271",228,58,18,40,1,155,52,103,9,8,1,5
"2011","N00003272 (Ballymacoss ward)","N00003272",236,105,14,91,1,109,36,73,17,15,2,4
"2011","N00003273 (Ballymacoss ward)","N00003273",264,235,49,186,1,5,2,3,21,18,3,2
"2011","N00003274 (Ballymacoss ward)","N00003274",117,52,11,41,0,54,26,28,5,4,1,6
"2011","N00003275 (Ballymacoss ward)","N00003275",95,44,12,32,3,39,39,0,6,6,0,3
"2011","N00003276 (Ballymacoss ward)","N00003276",245,203,27,176,10,16,15,1,12,10,2,4
"2011","N00003277 (Ballymacoss ward)","N00003277",180,154,44,110,6,4,3,1,15,13,2,1
"2011","N00003278 (Ballymacoss ward)","N00003278",183,104,48,56,5,48,47,1,24,24,0,2
"2011","N00003279 (Ballymacoss ward)","N00003279",96,45,10,35,2,42,42,0,5,5,0,2
"2011","N00003280 (Ballymacoss ward)","N00003280",329,275,100,175,7,7,4,3,38,32,6,2
"2011","N00003281 (Ballymacoss ward)","N00003281",127,113,64,49,0,4,4,0,8,8,0,2
"2011","N00003282 (Ballymacoss ward)","N00003282",835,637,111,526,15,70,45,25,101,95,6,12
"2011","N00003283 (Blaris ward)","N00003283",122,49,28,21,0,42,42,0,28,28,0,3
"2011","N00003284 (Blaris ward)","N00003284",135,58,32,26,1,28,28,0,43,40,3,5
"2011","N00003285 (Blaris ward)","N00003285",115,75,36,39,0,19,19,0,16,15,1,5
"2011","N00003286 (Blaris ward)","N00003286",123,87,35,52,3,0,0,0,31,27,4,2
"2011","N00003287 (Blaris ward)","N00003287",118,102,74,28,0,2,2,0,13,11,2,1
"2011","N00003288 (Blaris ward)","N00003288",123,90,44,46,1,4,4,0,24,23,1,4
"2011","N00003289 (Blaris ward)","N00003289",135,118,74,44,0,0,0,0,13,12,1,4
"2011","N00003290 (Blaris ward)","N00003290",177,136,74,62,0,22,20,2,13,11,2,6
"2011","N00003291 (Blaris ward)","N00003291",270,249,108,141,0,0,0,0,20,17,3,1
"2011","N00003292 (Blaris ward)","N00003292",123,113,57,56,0,0,0,0,10,7,3,0
"2011","N00003293 (Collin Glen ward)","N00003293",109,94,37,57,3,4,2,2,6,2,4,2
"2011","N00003307 (Derryaghy ward)","N00003307",211,179,39,140,7,10,9,1,13,11,2,2
"2011","N00003309 (Derryaghy ward)","N00003309",114,77,18,59,2,26,24,2,9,7,2,0
"2011","N00003310 (Derryaghy ward)","N00003310",126,64,31,33,0,55,55,0,7,6,1,0
"2011","N00003313 (Derryaghy ward)","N00003313",709,328,148,180,5,241,226,15,117,111,6,18
"2011","N00003314 (Derryaghy ward)","N00003314",293,251,81,170,1,1,1,0,38,38,0,2
"2011","N00003315 (Derryaghy ward)","N00003315",90,87,49,38,1,0,0,0,1,1,0,1
"2011","N00003316 (Derryaghy ward)","N00003316",155,103,37,66,0,32,32,0,13,10,3,7
"2011","N00003317 (Dromara ward)","N00003317",133,118,72,46,0,2,2,0,10,10,0,3
"2011","N00003318 (Dromara ward)","N00003318",315,295,136,159,1,5,3,2,10,10,0,4
"2011","N00003319 (Dromara ward)","N00003319",122,108,49,59,2,4,4,0,6,6,0,2
"2011","N00003320 (Dromara ward)","N00003320",110,89,31,58,0,14,14,0,6,5,1,1
"2011","N00003321 (Dromara ward)","N00003321",143,126,82,44,0,4,4,0,5,5,0,8
"2011","N00003322 (Dromara ward)","N00003322",142,133,81,52,0,3,2,1,5,4,1,1
"2011","N00003323 (Dromara ward)","N00003323",151,139,75,64,0,2,2,0,6,6,0,4
"2011","N00003324 (Dromara ward)","N00003324",140,110,48,62,1,3,3,0,21,17,4,5
"2011","N00003325 (Dromara ward)","N00003325",153,132,80,52,1,2,2,0,16,14,2,2
"2011","N00003326 (Dromara ward)","N00003326",261,183,63,120,2,16,16,0,51,49,2,9
"2011","N00003327 (Drumbo ward)","N00003327",154,131,73,58,0,3,2,1,17,17,0,3
"2011","N00003330 (Drumbo ward)","N00003330",137,122,64,58,0,1,1,0,11,11,0,3
"2011","N00003331 (Drumbo ward)","N00003331",167,151,82,69,0,1,1,0,10,10,0,5
"2011","N00003332 (Drumbo ward)","N00003332",136,123,70,53,0,1,1,0,8,7,1,4
"2011","N00003333 (Drumbo ward)","N00003333",125,96,57,39,0,16,16,0,12,11,1,1
"2011","N00003334 (Drumbo ward)","N00003334",119,110,74,36,0,2,2,0,3,2,1,4
"2011","N00003335 (Drumbo ward)","N00003335",107,74,33,41,0,26,26,0,6,4,2,1
"2011","N00003336 (Drumbo ward)","N00003336",133,123,67,56,0,3,2,1,6,5,1,1
"2011","N00003349 (Glenavy ward)","N00003349",341,282,75,207,3,1,1,0,49,45,4,6
"2011","N00003350 (Glenavy ward)","N00003350",177,161,78,83,0,4,3,1,4,3,1,8
"2011","N00003351 (Glenavy ward)","N00003351",143,111,46,65,1,21,20,1,6,3,3,4
"2011","N00003352 (Glenavy ward)","N00003352",155,131,30,101,1,3,3,0,15,12,3,5
"2011","N00003353 (Glenavy ward)","N00003353",131,112,24,88,2,1,1,0,15,11,4,1
"2011","N00003354 (Glenavy ward)","N00003354",153,139,54,85,0,3,3,0,7,4,3,4
"2011","N00003355 (Glenavy ward)","N00003355",145,133,72,61,0,2,1,1,4,3,1,6
"2011","N00003356 (Glenavy ward)","N00003356",219,195,38,157,4,2,2,0,15,13,2,3
"2011","N00003357 (Glenavy ward)","N00003357",120,110,62,48,0,4,4,0,5,5,0,1
"2011","N00003358 (Glenavy ward)","N00003358",147,139,73,66,0,1,0,1,3,3,0,4
"2011","N00003359 (Glenavy ward)","N00003359",132,121,65,56,0,2,2,0,6,6,0,3
"2011","N00003360 (Harmony Hill ward)","N00003360",109,60,23,37,5,34,34,0,5,5,0,5
"2011","N00003361 (Harmony Hill ward)","N00003361",140,102,68,34,1,18,13,5,17,15,2,2
"2011","N00003362 (Harmony Hill ward)","N00003362",128,118,61,57,0,0,0,0,10,6,4,0
"2011","N00003363 (Harmony Hill ward)","N00003363",297,239,118,121,2,37,12,25,16,11,5,3
"2011","N00003364 (Harmony Hill ward)","N00003364",139,109,67,42,1,2,1,1,27,4,23,0
"2011","N00003365 (Harmony Hill ward)","N00003365",176,163,115,48,0,3,2,1,9,9,0,1
"2011","N00003366 (Harmony Hill ward)","N00003366",123,92,37,55,0,3,2,1,22,19,3,6
"2011","N00003367 (Harmony Hill ward)","N00003367",139,127,66,61,0,1,1,0,10,9,1,1
"2011","N00003368 (Hilden ward)","N00003368",135,73,27,46,0,13,12,1,42,39,3,7
"2011","N00003369 (Hilden ward)","N00003369",149,58,28,30,2,42,9,33,45,40,5,2
"2011","N00003370 (Hilden ward)","N00003370",129,85,40,45,2,24,23,1,12,11,1,6
"2011","N00003371 (Hilden ward)","N00003371",159,65,26,39,3,34,33,1,50,49,1,7
"2011","N00003372 (Hilden ward)","N00003372",139,76,26,50,4,47,46,1,9,9,0,3
"2011","N00003373 (Hilden ward)","N00003373",129,64,29,35,2,42,40,2,16,14,2,5
"2011","N00003374 (Hilden ward)","N00003374",129,70,41,29,1,44,44,0,9,8,1,5
"2011","N00003375 (Hilden ward)","N00003375",127,61,19,42,4,43,43,0,15,15,0,4
"2011","N00003376 (Hilden ward)","N00003376",130,79,38,41,1,29,28,1,16,16,0,5
"2011","N00003377 (Hilden ward)","N00003377",110,50,19,31,0,31,31,0,26,25,1,3
"2011","N00003378 (Hillhall ward)","N00003378",124,77,39,38,1,25,25,0,13,13,0,8
"2011","N00003379 (Hillhall ward)","N00003379",124,70,40,30,0,31,30,1,18,15,3,5
"2011","N00003380 (Hillhall ward)","N00003380",145,57,20,37,1,78,76,2,5,4,1,4
"2011","N00003381 (Hillhall ward)","N00003381",138,55,29,26,2,70,62,8,6,4,2,5
"2011","N00003382 (Hillhall ward)","N00003382",127,43,23,20,0,53,52,1,21,20,1,10
"2011","N00003383 (Hillhall ward)","N00003383",125,87,56,31,0,29,27,2,6,6,0,3
"2011","N00003384 (Hillhall ward)","N00003384",153,128,70,58,2,5,5,0,13,10,3,5
"2011","N00003385 (Hillhall ward)","N00003385",164,133,81,52,0,12,12,0,13,12,1,6
"2011","N00003386 (Hillhall ward)","N00003386",146,86,42,44,0,38,38,0,20,19,1,2
"2011","N00003387 (Hillsborough ward)","N00003387",128,122,70,52,0,0,0,0,3,3,0,3
"2011","N00003388 (Hillsborough ward)","N00003388",164,135,83,52,1,5,5,0,18,18,0,5
"2011","N00003389 (Hillsborough ward)","N00003389",140,135,67,68,0,1,0,1,4,3,1,0
"2011","N00003390 (Hillsborough ward)","N00003390",151,103,33,70,1,35,35,0,7,7,0,5
"2011","N00003391 (Hillsborough ward)","N00003391",176,138,72,66,0,20,19,1,16,15,1,2
"2011","N00003392 (Hillsborough ward)","N00003392",146,131,79,52,0,1,1,0,6,4,2,8
"2011","N00003393 (Hillsborough ward)","N00003393",146,126,68,58,0,4,4,0,10,9,1,6
"2011","N00003394 (Hillsborough ward)","N00003394",135,119,77,42,0,1,1,0,9,7,2,6
"2011","N00003395 (Hillsborough ward)","N00003395",167,94,57,37,0,29,4,25,38,32,6,6
"2011","N00003396 (Hillsborough ward)","N00003396",163,152,81,71,0,0,0,0,7,6,1,4
"2011","N00003406 (Knockmore ward)","N00003406",165,67,26,41,1,74,40,34,20,15,5,3
"2011","N00003407 (Knockmore ward)","N00003407",242,200,86,114,10,3,2,1,26,24,2,3
"2011","N00003408 (Knockmore ward)","N00003408",197,144,36,108,5,22,6,16,23,20,3,3
"2011","N00003409 (Knockmore ward)","N00003409",155,113,42,71,7,6,6,0,26,24,2,3
"2011","N00003410 (Knockmore ward)","N00003410",238,178,66,112,5,16,14,2,36,35,1,3
"2011","N00003411 (Knockmore ward)","N00003411",107,78,13,65,0,13,13,0,15,15,0,1
"2011","N00003412 (Knockmore ward)","N00003412",132,49,13,36,2,65,65,0,6,3,3,10
"2011","N00003413 (Knockmore ward)","N00003413",132,69,20,49,1,43,43,0,15,12,3,4
"2011","N00003414 (Knockmore ward)","N00003414",128,74,43,31,0,6,6,0,46,5,41,2
"2011","N00003415 (Knockmore ward)","N00003415",132,79,25,54,2,41,40,1,9,7,2,1
"2011","N00003416 (Knockmore ward)","N00003416",121,58,15,43,2,47,47,0,10,7,3,4
"2011","N00003417 (Lagan Valley ward)","N00003417",119,61,32,29,2,48,34,14,1,1,0,7
"2011","N00003418 (Lagan Valley ward)","N00003418",132,49,15,34,0,76,70,6,5,5,0,2
"2011","N00003419 (Lagan Valley ward)","N00003419",124,111,61,50,0,2,2,0,11,10,1,0
"2011","N00003420 (Lagan Valley ward)","N00003420",125,38,16,22,3,73,72,1,5,5,0,6
"2011","N00003421 (Lagan Valley ward)","N00003421",113,54,23,31,1,44,42,2,9,9,0,5
"2011","N00003422 (Lagan Valley ward)","N00003422",256,146,76,70,1,75,23,52,28,24,4,6
"2011","N00003423 (Lagan Valley ward)","N00003423",249,94,50,44,2,111,32,79,34,29,5,8
"2011","N00003424 (Lagan Valley ward)","N00003424",129,87,42,45,3,23,20,3,16,15,1,0
"2011","N00003425 (Lagan Valley ward)","N00003425",95,49,25,24,2,29,28,1,15,15,0,0
"2011","N00003426 (Lambeg ward)","N00003426",350,203,75,128,0,79,63,16,56,53,3,12
"2011","N00003427 (Lambeg ward)","N00003427",140,115,56,59,2,12,11,1,11,9,2,0
"2011","N00003428 (Lambeg ward)","N00003428",129,106,40,66,3,4,2,2,15,14,1,1
"2011","N00003429 (Lambeg ward)","N00003429",127,57,26,31,0,55,52,3,12,12,0,3
"2011","N00003430 (Lambeg ward)","N00003430",103,49,23,26,0,43,42,1,9,8,1,2
"2011","N00003431 (Lambeg ward)","N00003431",132,69,38,31,0,52,51,1,9,9,0,2
"2011","N00003432 (Lambeg ward)","N00003432",139,108,48,60,1,14,13,1,16,15,1,0
"2011","N00003433 (Lambeg ward)","N00003433",116,71,30,41,3,35,33,2,4,4,0,3
"2011","N00003434 (Lisnagarvy ward)","N00003434",114,72,41,31,0,3,2,1,35,32,3,4
"2011","N00003435 (Lisnagarvy ward)","N00003435",101,87,70,17,0,0,0,0,8,7,1,6
"2011","N00003436 (Lisnagarvy ward)","N00003436",122,107,45,62,4,1,1,0,8,7,1,2
"2011","N00003437 (Lisnagarvy ward)","N00003437",131,122,83,39,0,0,0,0,8,8,0,1
"2011","N00003438 (Lisnagarvy ward)","N00003438",134,121,58,63,0,1,0,1,12,10,2,0
"2011","N00003439 (Lisnagarvy ward)","N00003439",124,115,83,32,0,0,0,0,6,5,1,3
"2011","N00003440 (Lisnagarvy ward)","N00003440",125,116,78,38,0,0,0,0,6,5,1,3
"2011","N00003441 (Lisnagarvy ward)","N00003441",131,111,49,62,3,2,0,2,10,9,1,5
"2011","N00003442 (Lisnagarvy ward)","N00003442",114,85,67,18,0,13,2,11,11,5,6,5
"2011","N00003443 (Maghaberry ward)","N00003443",252,229,46,183,4,0,0,0,18,15,3,1
"2011","N00003444 (Maghaberry ward)","N00003444",144,131,68,63,0,1,1,0,7,6,1,5
"2011","N00003445 (Maghaberry ward)","N00003445",165,151,33,118,2,1,1,0,11,9,2,0
"2011","N00003446 (Maghaberry ward)","N00003446",144,134,42,92,1,1,1,0,7,7,0,1
"2011","N00003447 (Maghaberry ward)","N00003447",123,101,40,61,1,10,10,0,5,4,1,6
"2011","N00003448 (Maghaberry ward)","N00003448",180,158,82,76,1,3,3,0,13,10,3,5
"2011","N00003449 (Maghaberry ward)","N00003449",144,130,77,53,0,1,1,0,11,11,0,2
"2011","N00003450 (Maghaberry ward)","N00003450",129,117,76,41,0,1,1,0,7,6,1,4
"2011","N00003451 (Maghaberry ward)","N00003451",222,189,56,133,6,5,5,0,18,16,2,4
"2011","N00003452 (Maghaberry ward)","N00003452",153,133,71,62,0,4,3,1,10,9,1,6
"2011","N00003453 (Magheralave ward)","N00003453",123,26,12,14,0,5,2,3,92,11,81,0
"2011","N00003454 (Magheralave ward)","N00003454",127,118,67,51,0,3,3,0,6,4,2,0
"2011","N00003455 (Magheralave ward)","N00003455",122,107,67,40,0,2,1,1,13,6,7,0
"2011","N00003456 (Magheralave ward)","N00003456",105,41,11,30,1,6,2,4,57,7,50,0
"2011","N00003457 (Magheralave ward)","N00003457",123,77,36,41,0,22,21,1,22,13,9,2
"2011","N00003458 (Magheralave ward)","N00003458",125,121,57,64,1,1,1,0,2,1,1,0
"2011","N00003459 (Magheralave ward)","N00003459",114,104,58,46,0,3,1,2,5,3,2,2
"2011","N00003460 (Magheralave ward)","N00003460",152,134,49,85,2,1,1,0,15,13,2,0
"2011","N00003461 (Magheralave ward)","N00003461",130,101,68,33,0,19,4,15,6,3,3,4
"2011","N00003462 (Magheralave ward)","N00003462",133,125,62,63,2,1,0,1,2,1,1,3
"2011","N00003463 (Maze ward)","N00003463",168,155,85,70,0,3,2,1,8,8,0,2
"2011","N00003464 (Maze ward)","N00003464",147,128,68,60,0,1,1,0,16,15,1,2
"2011","N00003465 (Maze ward)","N00003465",117,71,34,37,0,32,32,0,10,9,1,4
"2011","N00003466 (Maze ward)","N00003466",119,97,37,60,0,1,1,0,20,16,4,1
"2011","N00003467 (Maze ward)","N00003467",220,185,130,55,0,3,3,0,29,29,0,3
"2011","N00003468 (Maze ward)","N00003468",123,93,24,69,1,0,0,0,29,29,0,0
"2011","N00003469 (Maze ward)","N00003469",136,105,22,83,3,16,15,1,10,9,1,2
"2011","N00003470 (Maze ward)","N00003470",133,126,71,55,0,2,1,1,5,5,0,0
"2011","N00003471 (Maze ward)","N00003471",112,69,39,30,1,31,27,4,8,7,1,3
"2011","N00003472 (Maze ward)","N00003472",128,107,40,67,1,9,9,0,10,10,0,1
"2011","N00003473 (Maze ward)","N00003473",129,91,30,61,1,31,30,1,5,3,2,1
"2011","N00003474 (Moira ward)","N00003474",166,139,75,64,0,4,2,2,20,19,1,3
"2011","N00003475 (Moira ward)","N00003475",376,314,124,190,4,4,3,1,51,50,1,3
"2011","N00003476 (Moira ward)","N00003476",263,227,83,144,1,3,1,2,29,26,3,3
"2011","N00003477 (Moira ward)","N00003477",220,125,66,59,2,32,1,31,61,56,5,0
"2011","N00003478 (Moira ward)","N00003478",294,268,130,138,0,3,1,2,20,19,1,3
"2011","N00003479 (Moira ward)","N00003479",286,237,83,154,0,4,4,0,44,43,1,1
"2011","N00003480 (Moira ward)","N00003480",117,50,24,26,1,37,37,0,20,17,3,9
"2011","N00003481 (Moira ward)","N00003481",70,58,19,39,0,0,0,0,12,12,0,0
"2011","N00003482 (Moira ward)","N00003482",122,69,34,35,0,23,22,1,27,21,6,3
"2011","N00003483 (Old Warren ward)","N00003483",161,57,22,35,0,87,68,19,14,11,3,3
"2011","N00003484 (Old Warren ward)","N00003484",123,52,18,34,3,51,45,6,14,12,2,3
"2011","N00003485 (Old Warren ward)","N00003485",114,75,41,34,4,25,24,1,8,7,1,2
"2011","N00003486 (Old Warren ward)","N00003486",143,56,24,32,3,69,43,26,14,12,2,1
"2011","N00003487 (Old Warren ward)","N00003487",153,45,20,25,0,89,77,12,10,9,1,9
"2011","N00003488 (Old Warren ward)","N00003488",121,26,6,20,1,84,82,2,5,5,0,5
"2011","N00003489 (Old Warren ward)","N00003489",302,69,21,48,2,201,168,33,14,11,3,16
"2011","N00003497 (Seymour Hill ward)","N00003497",216,87,43,44,1,104,89,15,16,14,2,8
"2011","N00003498 (Seymour Hill ward)","N00003498",119,65,32,33,0,37,36,1,8,8,0,9
"2011","N00003499 (Seymour Hill ward)","N00003499",104,67,30,37,3,23,22,1,7,6,1,4
"2011","N00003502 (Seymour Hill ward)","N00003502",131,27,11,16,0,84,65,19,12,11,1,8
"2011","N00003505 (Seymour Hill ward)","N00003505",101,42,16,26,0,49,49,0,7,6,1,3
"2011","N00003506 (Tonagh ward)","N00003506",169,71,35,36,1,62,27,35,32,32,0,3
"2011","N00003507 (Tonagh ward)","N00003507",107,29,8,21,1,63,63,0,9,9,0,5
"2011","N00003508 (Tonagh ward)","N00003508",119,63,18,45,0,34,34,0,19,14,5,3
"2011","N00003509 (Tonagh ward)","N00003509",119,100,63,37,0,2,1,1,11,10,1,6
"2011","N00003510 (Tonagh ward)","N00003510",120,81,40,41,1,18,18,0,18,16,2,2
"2011","N00003511 (Tonagh ward)","N00003511",99,53,25,28,1,11,10,1,30,27,3,4
"2011","N00003512 (Tonagh ward)","N00003512",120,73,35,38,0,29,29,0,17,15,2,1
"2011","N00003513 (Tonagh ward)","N00003513",218,127,63,64,3,59,59,0,19,14,5,10
"2011","N00003521 (Wallace Park ward)","N00003521",120,98,61,37,1,1,0,1,19,11,8,1
"2011","N00003522 (Wallace Park ward)","N00003522",146,111,60,51,1,16,3,13,13,8,5,5
"2011","N00003523 (Wallace Park ward)","N00003523",146,134,78,56,0,1,0,1,10,8,2,1
"2011","N00003524 (Wallace Park ward)","N00003524",449,348,204,144,1,4,1,3,91,21,70,5
"2011","N00003525 (Wallace Park ward)","N00003525",134,125,67,58,0,2,0,2,5,5,0,2
"2011","N00003526 (Wallace Park ward)","N00003526",130,95,65,30,0,0,0,0,32,17,15,3
"2011","N00000477 (Academy ward)","N00000477",283,261,155,106,0,2,2,0,14,12,2,6
"2011","N00000478 (Academy ward)","N00000478",129,67,42,25,2,16,15,1,43,40,3,1
"2011","N00000479 (Academy ward)","N00000479",117,110,83,27,0,2,1,1,2,0,2,3
"2011","N00000480 (Academy ward)","N00000480",132,117,87,30,0,1,1,0,13,12,1,1
"2011","N00000481 (Academy ward)","N00000481",175,139,96,43,0,5,0,5,21,20,1,10
"2011","N00000482 (Ahoghill ward)","N00000482",121,36,16,20,1,61,38,23,16,16,0,7
"2011","N00000483 (Ahoghill ward)","N00000483",115,109,75,34,0,0,0,0,6,5,1,0
"2011","N00000484 (Ahoghill ward)","N00000484",139,91,36,55,1,35,35,0,11,10,1,1
"2011","N00000485 (Ahoghill ward)","N00000485",108,74,43,31,0,19,19,0,8,6,2,7
"2011","N00000486 (Ahoghill ward)","N00000486",116,101,31,70,0,1,1,0,14,14,0,0
"2011","N00000487 (Ahoghill ward)","N00000487",113,106,52,54,0,1,1,0,5,5,0,1
"2011","N00000488 (Ahoghill ward)","N00000488",134,118,46,72,1,2,2,0,9,7,2,4
"2011","N00000489 (Ahoghill ward)","N00000489",107,100,51,49,1,0,0,0,6,6,0,0
"2011","N00000490 (Ahoghill ward)","N00000490",194,153,49,104,2,1,0,1,34,32,2,4
"2011","N00000491 (Ahoghill ward)","N00000491",166,134,47,87,1,1,1,0,28,28,0,2
"2011","N00000492 (Ahoghill ward)","N00000492",177,121,58,63,3,13,13,0,33,29,4,7
"2011","N00000493 (Ardeevin ward)","N00000493",140,129,91,38,1,0,0,0,8,8,0,2
"2011","N00000494 (Ardeevin ward)","N00000494",347,269,146,123,2,0,0,0,67,60,7,9
"2011","N00000495 (Ardeevin ward)","N00000495",136,120,71,49,1,0,0,0,11,9,2,4
"2011","N00000496 (Ardeevin ward)","N00000496",310,236,63,173,2,1,0,1,69,62,7,2
"2011","N00000497 (Ardeevin ward)","N00000497",328,223,90,133,0,20,20,0,79,73,6,6
"2011","N00000498 (Ardeevin ward)","N00000498",128,109,66,43,0,0,0,0,16,13,3,3
"2011","N00000499 (Ballee ward)","N00000499",129,97,41,56,2,18,17,1,8,7,1,4
"2011","N00000500 (Ballee ward)","N00000500",249,101,50,51,0,111,81,30,29,28,1,8
"2011","N00000501 (Ballee ward)","N00000501",151,54,25,29,1,75,72,3,10,9,1,11
"2011","N00000502 (Ballee ward)","N00000502",89,23,12,11,0,57,56,1,6,6,0,3
"2011","N00000503 (Ballee ward)","N00000503",133,47,17,30,1,73,73,0,8,7,1,4
"2011","N00000504 (Ballee ward)","N00000504",108,27,13,14,0,70,70,0,5,4,1,6
"2011","N00000505 (Ballykeel ward)","N00000505",94,36,11,25,0,46,46,0,8,8,0,4
"2011","N00000506 (Ballykeel ward)","N00000506",113,93,35,58,2,6,6,0,10,9,1,2
"2011","N00000507 (Ballykeel ward)","N00000507",114,45,19,26,0,56,56,0,10,10,0,3
"2011","N00000508 (Ballykeel ward)","N00000508",129,103,54,49,3,11,10,1,11,9,2,1
"2011","N00000509 (Ballykeel ward)","N00000509",127,39,13,26,0,78,78,0,5,4,1,5
"2011","N00000510 (Ballykeel ward)","N00000510",108,24,8,16,2,69,69,0,10,8,2,3
"2011","N00000511 (Ballyloughan ward)","N00000511",157,129,82,47,0,3,3,0,21,20,1,4
"2011","N00000512 (Ballyloughan ward)","N00000512",174,160,118,42,0,1,1,0,9,7,2,4
"2011","N00000513 (Ballyloughan ward)","N00000513",131,113,65,48,1,1,1,0,14,11,3,2
"2011","N00000514 (Ballyloughan ward)","N00000514",141,123,77,46,0,0,0,0,11,10,1,7
"2011","N00000515 (Ballyloughan ward)","N00000515",124,109,62,47,0,0,0,0,14,13,1,1
"2011","N00000516 (Ballyloughan ward)","N00000516",92,84,51,33,0,0,0,0,8,8,0,0
"2011","N00000517 (Ballyloughan ward)","N00000517",125,118,69,49,0,0,0,0,7,6,1,0
"2011","N00000518 (Broughshane ward)","N00000518",119,89,61,28,1,1,1,0,21,19,2,7
"2011","N00000519 (Broughshane ward)","N00000519",118,100,65,35,0,1,1,0,15,13,2,2
"2011","N00000520 (Broughshane ward)","N00000520",269,175,105,70,0,50,48,2,33,29,4,11
"2011","N00000521 (Broughshane ward)","N00000521",183,105,68,37,3,24,23,1,44,41,3,7
"2011","N00000522 (Broughshane ward)","N00000522",181,128,58,70,1,27,19,8,21,21,0,4
"2011","N00000523 (Broughshane ward)","N00000523",154,133,77,56,3,0,0,0,15,14,1,3
"2011","N00000524 (Broughshane ward)","N00000524",177,154,84,70,0,3,3,0,16,14,2,4
"2011","N00000525 (Broughshane ward)","N00000525",211,106,47,59,1,47,18,29,43,40,3,14
"2011","N00000526 (Castle Demesne ward)","N00000526",117,58,38,20,0,8,7,1,49,44,5,2
"2011","N00000527 (Castle Demesne ward)","N00000527",133,65,24,41,3,6,6,0,59,55,4,0
"2011","N00000528 (Castle Demesne ward)","N00000528",111,27,16,11,0,22,21,1,59,57,2,3
"2011","N00000529 (Castle Demesne ward)","N00000529",135,53,43,10,2,35,35,0,38,33,5,7
"2011","N00000530 (Castle Demesne ward)","N00000530",130,90,63,27,0,5,4,1,30,26,4,5
"2011","N00000531 (Castle Demesne ward)","N00000531",151,56,33,23,1,24,2,22,62,59,3,8
"2011","N00000532 (Castle Demesne ward)","N00000532",105,36,21,15,1,13,13,0,51,47,4,4
"2011","N00000533 (Castle Demesne ward)","N00000533",159,35,30,5,0,89,39,50,26,13,13,9
"2011","N00000534 (Craigywarren ward)","N00000534",169,144,84,60,1,2,2,0,14,12,2,8
"2011","N00000535 (Craigywarren ward)","N00000535",183,171,100,71,0,1,1,0,10,7,3,1
"2011","N00000536 (Craigywarren ward)","N00000536",148,120,71,49,0,12,12,0,14,14,0,2
"2011","N00000537 (Craigywarren ward)","N00000537",142,127,78,49,0,0,0,0,13,12,1,2
"2011","N00000538 (Craigywarren ward)","N00000538",148,122,85,37,0,1,1,0,17,14,3,8
"2011","N00000539 (Craigywarren ward)","N00000539",139,112,68,44,0,6,6,0,19,14,5,2
"2011","N00000540 (Cullybackey ward)","N00000540",123,106,77,29,0,6,6,0,9,9,0,2
"2011","N00000541 (Cullybackey ward)","N00000541",158,135,73,62,0,3,3,0,18,16,2,2
"2011","N00000542 (Cullybackey ward)","N00000542",130,69,44,25,0,45,21,24,9,8,1,7
"2011","N00000543 (Cullybackey ward)","N00000543",138,112,51,61,0,23,5,18,1,1,0,2
"2011","N00000544 (Cullybackey ward)","N00000544",128,65,39,26,2,27,27,0,29,27,2,5
"2011","N00000545 (Cullybackey ward)","N00000545",126,64,29,35,1,47,47,0,8,7,1,6
"2011","N00000546 (Cullybackey ward)","N00000546",120,75,48,27,2,26,26,0,16,13,3,1
"2011","N00000547 (Cullybackey ward)","N00000547",143,82,36,46,0,37,22,15,18,18,0,6
"2011","N00000548 (Cullybackey ward)","N00000548",114,66,37,29,0,19,19,0,29,29,0,0
"2011","N00000549 (Dunclug ward)","N00000549",115,22,9,13,0,67,39,28,19,19,0,7
"2011","N00000550 (Dunclug ward)","N00000550",180,107,41,66,0,31,8,23,39,36,3,3
"2011","N00000551 (Dunclug ward)","N00000551",100,32,13,19,1,32,32,0,33,32,1,2
"2011","N00000552 (Dunclug ward)","N00000552",101,61,24,37,0,19,19,0,19,16,3,2
"2011","N00000553 (Dunclug ward)","N00000553",131,62,20,42,1,29,29,0,37,30,7,2
"2011","N00000554 (Dunclug ward)","N00000554",103,31,8,23,0,48,47,1,21,19,2,3
"2011","N00000555 (Dunclug ward)","N00000555",110,40,16,24,1,39,39,0,26,25,1,4
"2011","N00000556 (Dunclug ward)","N00000556",115,50,18,32,2,33,32,1,28,26,2,2
"2011","N00000557 (Dunminning ward)","N00000557",167,154,97,57,0,1,1,0,7,7,0,5
"2011","N00000558 (Dunminning ward)","N00000558",148,135,84,51,0,2,2,0,6,5,1,5
"2011","N00000559 (Dunminning ward)","N00000559",124,105,69,36,0,4,3,1,11,10,1,4
"2011","N00000560 (Dunminning ward)","N00000560",146,131,82,49,0,2,1,1,11,7,4,2
"2011","N00000561 (Dunminning ward)","N00000561",162,142,84,58,0,1,1,0,9,9,0,10
"2011","N00000562 (Dunminning ward)","N00000562",143,110,65,45,0,12,12,0,12,9,3,9
"2011","N00000563 (Fair Green ward)","N00000563",356,220,107,113,3,57,54,3,69,64,5,7
"2011","N00000564 (Fair Green ward)","N00000564",138,73,49,24,1,23,23,0,32,26,6,9
"2011","N00000565 (Fair Green ward)","N00000565",124,72,53,19,0,32,32,0,19,17,2,1
"2011","N00000566 (Fair Green ward)","N00000566",123,85,41,44,0,12,2,10,23,23,0,3
"2011","N00000567 (Galgorm ward)","N00000567",200,165,89,76,0,3,2,1,24,24,0,8
"2011","N00000568 (Galgorm ward)","N00000568",130,109,39,70,2,2,2,0,16,13,3,1
"2011","N00000569 (Galgorm ward)","N00000569",167,110,71,39,2,25,23,2,28,24,4,2
"2011","N00000570 (Galgorm ward)","N00000570",129,115,53,62,2,0,0,0,10,10,0,2
"2011","N00000571 (Galgorm ward)","N00000571",120,109,63,46,2,0,0,0,7,7,0,2
"2011","N00000572 (Galgorm ward)","N00000572",200,182,70,112,0,10,10,0,6,6,0,2
"2011","N00000573 (Galgorm ward)","N00000573",138,122,63,59,0,1,1,0,14,14,0,1
"2011","N00000574 (Galgorm ward)","N00000574",149,133,56,77,0,2,1,1,10,9,1,4
"2011","N00000575 (Glenravel ward)","N00000575",160,146,95,51,0,0,0,0,12,11,1,2
"2011","N00000576 (Glenravel ward)","N00000576",131,87,28,59,0,17,17,0,22,18,4,5
"2011","N00000577 (Glenravel ward)","N00000577",154,124,67,57,1,3,2,1,19,18,1,7
"2011","N00000578 (Glenravel ward)","N00000578",243,195,89,106,0,3,3,0,41,35,6,4
"2011","N00000579 (Glenravel ward)","N00000579",149,114,49,65,0,12,10,2,22,20,2,1
"2011","N00000580 (Glenravel ward)","N00000580",177,136,77,59,1,12,11,1,22,16,6,6
"2011","N00000581 (Glenravel ward)","N00000581",160,143,68,75,1,3,3,0,9,8,1,4
"2011","N00000582 (Glenwhirry ward)","N00000582",142,129,73,56,0,2,2,0,11,9,2,0
"2011","N00000583 (Glenwhirry ward)","N00000583",118,106,70,36,0,4,4,0,6,6,0,2
"2011","N00000584 (Glenwhirry ward)","N00000584",157,139,77,62,0,1,1,0,14,10,4,3
"2011","N00000585 (Glenwhirry ward)","N00000585",155,129,80,49,1,1,1,0,13,8,5,11
"2011","N00000586 (Glenwhirry ward)","N00000586",154,136,74,62,1,1,1,0,14,13,1,2
"2011","N00000587 (Glenwhirry ward)","N00000587",154,139,74,65,0,0,0,0,11,7,4,4
"2011","N00000588 (Glenwhirry ward)","N00000588",139,116,53,63,1,6,6,0,12,10,2,4
"2011","N00000589 (Grange ward)","N00000589",182,162,84,78,0,1,1,0,12,10,2,7
"2011","N00000590 (Grange ward)","N00000590",137,115,69,46,0,6,6,0,9,7,2,7
"2011","N00000591 (Grange ward)","N00000591",155,138,90,48,1,1,1,0,7,7,0,8
"2011","N00000592 (Grange ward)","N00000592",188,144,46,98,4,14,12,2,21,19,2,5
"2011","N00000593 (Grange ward)","N00000593",171,161,78,83,0,1,1,0,6,5,1,3
"2011","N00000594 (Grange ward)","N00000594",130,114,61,53,0,4,4,0,6,5,1,6
"2011","N00000595 (Grange ward)","N00000595",185,156,68,88,1,1,1,0,22,21,1,5
"2011","N00000596 (Harryville ward)","N00000596",120,106,76,30,0,1,1,0,9,9,0,4
"2011","N00000597 (Harryville ward)","N00000597",121,46,23,23,0,32,32,0,39,36,3,4
"2011","N00000598 (Harryville ward)","N00000598",152,66,27,39,3,5,4,1,75,74,1,3
"2011","N00000599 (Harryville ward)","N00000599",114,30,12,18,0,53,51,2,28,28,0,3
"2011","N00000600 (Harryville ward)","N00000600",122,92,58,34,4,0,0,0,21,20,1,5
"2011","N00000601 (Harryville ward)","N00000601",133,92,51,41,0,0,0,0,35,33,2,6
"2011","N00000602 (Harryville ward)","N00000602",111,100,75,25,1,1,1,0,6,5,1,3
"2011","N00000603 (Kells ward)","N00000603",151,116,47,69,2,15,15,0,13,13,0,5
"2011","N00000604 (Kells ward)","N00000604",132,97,39,58,0,17,17,0,14,13,1,4
"2011","N00000605 (Kells ward)","N00000605",196,140,54,86,0,11,11,0,40,39,1,5
"2011","N00000606 (Kells ward)","N00000606",124,97,21,76,1,4,4,0,22,19,3,0
"2011","N00000607 (Kells ward)","N00000607",129,60,22,38,2,51,51,0,14,12,2,2
"2011","N00000608 (Kells ward)","N00000608",138,117,78,39,0,1,1,0,12,11,1,8
"2011","N00000609 (Kells ward)","N00000609",136,116,58,58,0,9,9,0,6,5,1,5
"2011","N00000610 (Kells ward)","N00000610",147,127,54,73,1,1,1,0,12,11,1,6
"2011","N00000611 (Kells ward)","N00000611",122,100,61,39,1,5,5,0,10,9,1,6
"2011","N00000612 (Moat ward)","N00000612",246,108,67,41,4,59,59,0,65,60,5,10
"2011","N00000613 (Moat ward)","N00000613",112,44,25,19,0,51,48,3,16,12,4,1
"2011","N00000614 (Moat ward)","N00000614",119,40,24,16,0,57,57,0,17,17,0,5
"2011","N00000615 (Moat ward)","N00000615",87,26,15,11,0,55,47,8,2,2,0,4
"2011","N00000616 (Moat ward)","N00000616",129,81,45,36,0,31,24,7,11,11,0,6
"2011","N00000617 (Moat ward)","N00000617",133,70,35,35,1,54,53,1,6,6,0,2
"2011","N00000618 (Park ward)","N00000618",271,127,60,67,3,16,16,0,114,110,4,11
"2011","N00000619 (Park ward)","N00000619",141,134,78,56,0,1,1,0,5,4,1,1
"2011","N00000620 (Park ward)","N00000620",139,118,51,67,2,0,0,0,17,14,3,2
"2011","N00000621 (Park ward)","N00000621",176,100,72,28,2,2,0,2,68,63,5,4
"2011","N00000622 (Park ward)","N00000622",164,109,62,47,0,0,0,0,49,46,3,6
"2011","N00000623 (Portglenone ward)","N00000623",125,96,67,29,0,10,10,0,13,11,2,6
"2011","N00000624 (Portglenone ward)","N00000624",160,144,96,48,0,1,0,1,13,11,2,2
"2011","N00000625 (Portglenone ward)","N00000625",118,58,24,34,0,16,16,0,35,30,5,9
"2011","N00000626 (Portglenone ward)","N00000626",156,140,95,45,0,1,1,0,7,2,5,8
"2011","N00000627 (Portglenone ward)","N00000627",159,130,76,54,0,5,5,0,18,17,1,6
"2011","N00000628 (Portglenone ward)","N00000628",141,121,78,43,1,2,1,1,11,11,0,6
"2011","N00000629 (Portglenone ward)","N00000629",171,110,39,71,0,29,6,23,26,24,2,6
"2011","N00000630 (Portglenone ward)","N00000630",126,53,23,30,0,46,35,11,20,18,2,7
"2011","N00000631 (Slemish ward)","N00000631",137,117,81,36,0,2,2,0,13,11,2,5
"2011","N00000632 (Slemish ward)","N00000632",156,119,74,45,0,1,1,0,30,29,1,6
"2011","N00000633 (Slemish ward)","N00000633",126,110,77,33,0,3,2,1,10,10,0,3
"2011","N00000634 (Slemish ward)","N00000634",166,150,81,69,0,0,0,0,10,8,2,6
"2011","N00000635 (Slemish ward)","N00000635",153,123,91,32,2,1,1,0,19,15,4,8
"2011","N00000636 (Slemish ward)","N00000636",143,121,88,33,1,1,1,0,15,13,2,5
"2011","N00000637 (Summerfield ward)","N00000637",305,199,86,113,2,52,34,18,50,47,3,2
"2011","N00000638 (Summerfield ward)","N00000638",136,110,50,60,5,2,1,1,18,17,1,1
"2011","N00000639 (Summerfield ward)","N00000639",143,128,69,59,0,1,1,0,13,12,1,1
"2011","N00000640 (Summerfield ward)","N00000640",132,78,39,39,2,25,21,4,27,23,4,0
"2011","N00000641 (Summerfield ward)","N00000641",129,114,69,45,0,2,2,0,11,8,3,2
"2011","N00000642 (Summerfield ward)","N00000642",145,108,34,74,1,0,0,0,34,29,5,2
"2011","N00001641 (Blackhead ward)","N00001641",131,71,33,38,0,41,39,2,18,13,5,1
"2011","N00001642 (Blackhead ward)","N00001642",124,118,79,39,0,0,0,0,5,4,1,1
"2011","N00001643 (Blackhead ward)","N00001643",257,183,81,102,5,15,13,2,50,47,3,4
"2011","N00001644 (Blackhead ward)","N00001644",125,115,47,68,0,1,1,0,7,6,1,2
"2011","N00001645 (Blackhead ward)","N00001645",117,52,15,37,1,46,46,0,15,13,2,3
"2011","N00001646 (Blackhead ward)","N00001646",136,74,39,35,3,25,25,0,32,27,5,2
"2011","N00001647 (Bluefield ward)","N00001647",127,117,69,48,0,0,0,0,7,6,1,3
"2011","N00001648 (Bluefield ward)","N00001648",143,131,68,63,1,1,1,0,7,7,0,3
"2011","N00001649 (Bluefield ward)","N00001649",134,118,45,73,1,1,1,0,7,5,2,7
"2011","N00001650 (Bluefield ward)","N00001650",118,107,40,67,1,0,0,0,10,10,0,0
"2011","N00001651 (Bluefield ward)","N00001651",134,126,33,93,0,2,1,1,5,4,1,1
"2011","N00001652 (Bluefield ward)","N00001652",132,123,44,79,0,2,1,1,4,3,1,3
"2011","N00001653 (Bluefield ward)","N00001653",136,129,19,110,0,1,1,0,5,5,0,1
"2011","N00001654 (Bluefield ward)","N00001654",139,126,30,96,2,0,0,0,11,9,2,0
"2011","N00001655 (Boneybefore ward)","N00001655",159,132,55,77,1,0,0,0,25,24,1,1
"2011","N00001656 (Boneybefore ward)","N00001656",118,92,56,36,1,19,1,18,5,4,1,1
"2011","N00001657 (Boneybefore ward)","N00001657",119,108,72,36,0,0,0,0,9,9,0,2
"2011","N00001658 (Boneybefore ward)","N00001658",95,62,39,23,0,26,1,25,5,5,0,2
"2011","N00001659 (Boneybefore ward)","N00001659",112,105,70,35,0,0,0,0,4,4,0,3
"2011","N00001660 (Boneybefore ward)","N00001660",123,116,77,39,0,1,0,1,6,6,0,0
"2011","N00001661 (Burleigh Hill ward)","N00001661",122,113,20,93,2,0,0,0,5,4,1,2
"2011","N00001662 (Burleigh Hill ward)","N00001662",125,113,43,70,4,0,0,0,5,4,1,3
"2011","N00001663 (Burleigh Hill ward)","N00001663",128,116,52,64,3,0,0,0,6,5,1,3
"2011","N00001664 (Burleigh Hill ward)","N00001664",118,110,36,74,2,0,0,0,6,6,0,0
"2011","N00001665 (Burleigh Hill ward)","N00001665",152,130,40,90,2,0,0,0,18,16,2,2
"2011","N00001666 (Burleigh Hill ward)","N00001666",125,120,52,68,0,1,1,0,3,3,0,1
"2011","N00001667 (Burleigh Hill ward)","N00001667",117,111,31,80,0,0,0,0,5,5,0,1
"2011","N00001668 (Burleigh Hill ward)","N00001668",156,120,45,75,0,30,4,26,2,2,0,4
"2011","N00001669 (Burleigh Hill ward)","N00001669",117,111,54,57,1,1,1,0,4,3,1,0
"2011","N00001670 (Clipperstown ward)","N00001670",125,56,15,41,2,50,46,4,15,11,4,2
"2011","N00001671 (Clipperstown ward)","N00001671",129,46,14,32,3,61,60,1,15,15,0,4
"2011","N00001672 (Clipperstown ward)","N00001672",134,76,18,58,2,19,19,0,34,34,0,3
"2011","N00001673 (Clipperstown ward)","N00001673",176,126,35,91,2,14,14,0,27,27,0,7
"2011","N00001674 (Clipperstown ward)","N00001674",114,55,20,35,3,31,31,0,24,23,1,1
"2011","N00001675 (Clipperstown ward)","N00001675",123,79,35,44,2,14,14,0,24,24,0,4
"2011","N00001676 (Clipperstown ward)","N00001676",107,52,20,32,3,35,35,0,16,16,0,1
"2011","N00001677 (Eden ward)","N00001677",163,157,29,128,0,0,0,0,6,6,0,0
"2011","N00001678 (Eden ward)","N00001678",148,132,66,66,0,0,0,0,10,9,1,6
"2011","N00001679 (Eden ward)","N00001679",134,128,30,98,1,1,1,0,2,1,1,2
"2011","N00001680 (Eden ward)","N00001680",170,154,15,139,0,0,0,0,14,12,2,2
"2011","N00001681 (Eden ward)","N00001681",147,98,40,58,3,14,14,0,29,26,3,3
"2011","N00001682 (Eden ward)","N00001682",127,109,33,76,0,3,3,0,15,14,1,0
"2011","N00001683 (Eden ward)","N00001683",155,67,28,39,1,63,8,55,18,14,4,6
"2011","N00001684 (Eden ward)","N00001684",286,271,47,224,2,1,0,1,12,11,1,0
"2011","N00001685 (Eden ward)","N00001685",120,113,46,67,0,1,0,1,6,5,1,0
"2011","N00001686 (Eden ward)","N00001686",114,87,21,66,2,2,2,0,23,22,1,0
"2011","N00001687 (Eden ward)","N00001687",118,108,47,61,0,2,1,1,6,5,1,2
"2011","N00001688 (Gortalee ward)","N00001688",158,92,33,59,1,50,22,28,13,11,2,2
"2011","N00001689 (Gortalee ward)","N00001689",156,38,22,16,0,65,63,2,40,38,2,13
"2011","N00001690 (Gortalee ward)","N00001690",141,117,55,62,0,13,13,0,10,9,1,1
"2011","N00001691 (Gortalee ward)","N00001691",154,52,19,33,0,90,90,0,8,6,2,4
"2011","N00001692 (Gortalee ward)","N00001692",124,63,28,35,1,38,38,0,15,13,2,7
"2011","N00001693 (Greenisland ward)","N00001693",125,88,55,33,0,2,1,1,28,24,4,7
"2011","N00001694 (Greenisland ward)","N00001694",104,95,45,50,2,0,0,0,7,7,0,0
"2011","N00001695 (Greenisland ward)","N00001695",152,134,38,96,0,2,2,0,15,15,0,1
"2011","N00001696 (Greenisland ward)","N00001696",168,135,70,65,0,1,1,0,31,30,1,1
"2011","N00001697 (Greenisland ward)","N00001697",121,93,50,43,0,12,12,0,15,12,3,1
"2011","N00001698 (Greenisland ward)","N00001698",131,76,30,46,2,33,33,0,16,14,2,4
"2011","N00001699 (Greenisland ward)","N00001699",158,131,44,87,0,4,4,0,23,22,1,0
"2011","N00001700 (Greenisland ward)","N00001700",124,63,21,42,1,43,43,0,14,12,2,3
"2011","N00001701 (Killycrot ward)","N00001701",102,63,30,33,0,26,26,0,12,10,2,1
"2011","N00001702 (Killycrot ward)","N00001702",140,98,46,52,1,10,10,0,24,21,3,7
"2011","N00001703 (Killycrot ward)","N00001703",613,288,138,150,6,151,67,84,157,149,8,11
"2011","N00001704 (Killycrot ward)","N00001704",450,188,98,90,2,101,37,64,141,131,10,18
"2011","N00001705 (Killycrot ward)","N00001705",118,53,19,34,0,10,9,1,49,46,3,6
"2011","N00001706 (Knockagh ward)","N00001706",166,159,59,100,0,0,0,0,7,6,1,0
"2011","N00001707 (Knockagh ward)","N00001707",145,129,52,77,0,1,1,0,12,10,2,3
"2011","N00001708 (Knockagh ward)","N00001708",241,213,59,154,0,3,3,0,23,21,2,2
"2011","N00001709 (Knockagh ward)","N00001709",120,72,34,38,0,29,29,0,15,13,2,4
"2011","N00001710 (Knockagh ward)","N00001710",136,133,92,41,0,0,0,0,1,1,0,2
"2011","N00001711 (Knockagh ward)","N00001711",137,127,67,60,0,0,0,0,9,9,0,1
"2011","N00001712 (Love Lane ward)","N00001712",158,78,39,39,1,42,40,2,35,28,7,2
"2011","N00001713 (Love Lane ward)","N00001713",110,51,38,13,0,51,27,24,7,6,1,1
"2011","N00001714 (Love Lane ward)","N00001714",260,111,34,77,5,119,103,16,15,10,5,10
"2011","N00001715 (Love Lane ward)","N00001715",127,59,19,40,1,56,56,0,9,7,2,2
"2011","N00001716 (Milebush ward)","N00001716",124,115,65,50,1,1,1,0,6,6,0,1
"2011","N00001717 (Milebush ward)","N00001717",132,116,34,82,1,1,1,0,14,13,1,0
"2011","N00001718 (Milebush ward)","N00001718",125,102,52,50,4,2,1,1,14,12,2,3
"2011","N00001719 (Milebush ward)","N00001719",123,59,19,40,0,49,47,2,13,11,2,2
"2011","N00001720 (Milebush ward)","N00001720",122,91,42,49,2,18,18,0,6,3,3,5
"2011","N00001721 (Northland ward)","N00001721",117,66,25,41,2,26,26,0,21,20,1,2
"2011","N00001722 (Northland ward)","N00001722",148,67,14,53,4,45,36,9,27,22,5,5
"2011","N00001723 (Northland ward)","N00001723",127,74,28,46,1,28,28,0,22,19,3,2
"2011","N00001724 (Northland ward)","N00001724",105,59,17,42,0,31,31,0,14,14,0,1
"2011","N00001725 (Northland ward)","N00001725",117,63,22,41,0,36,35,1,16,15,1,2
"2011","N00001726 (Sunnylands ward)","N00001726",119,65,27,38,1,36,35,1,12,8,4,5
"2011","N00001727 (Sunnylands ward)","N00001727",114,50,28,22,2,41,39,2,12,12,0,9
"2011","N00001728 (Sunnylands ward)","N00001728",137,72,24,48,1,48,48,0,14,12,2,2
"2011","N00001729 (Sunnylands ward)","N00001729",136,86,40,46,2,20,20,0,25,24,1,3
"2011","N00001730 (Sunnylands ward)","N00001730",133,75,42,33,0,32,31,1,23,23,0,3
"2011","N00001731 (Sunnylands ward)","N00001731",125,48,27,21,0,55,55,0,17,16,1,5
"2011","N00001732 (Victoria ward)","N00001732",351,311,85,226,0,3,1,2,36,31,5,1
"2011","N00001733 (Victoria ward)","N00001733",120,72,31,41,3,22,22,0,20,20,0,3
"2011","N00001734 (Victoria ward)","N00001734",120,99,53,46,2,9,8,1,10,9,1,0
"2011","N00001735 (Victoria ward)","N00001735",125,97,46,51,1,7,7,0,18,17,1,2
"2011","N00001736 (Victoria ward)","N00001736",199,62,32,30,0,102,48,54,23,21,2,12
"2011","N00001737 (Victoria ward)","N00001737",168,112,40,72,1,22,22,0,32,27,5,1
"2011","N00001738 (Whitehead ward)","N00001738",133,127,75,52,0,0,0,0,5,4,1,1
"2011","N00001739 (Whitehead ward)","N00001739",145,127,73,54,0,0,0,0,16,14,2,2
"2011","N00001740 (Whitehead ward)","N00001740",292,211,107,104,2,33,33,0,35,29,6,11
"2011","N00001741 (Whitehead ward)","N00001741",116,102,56,46,0,4,3,1,9,7,2,1
"2011","N00001742 (Whitehead ward)","N00001742",109,65,24,41,0,13,13,0,27,24,3,4
"2011","N00001743 (Whitehead ward)","N00001743",122,74,39,35,0,24,4,20,23,22,1,1
"2011","N00001744 (Woodburn ward)","N00001744",128,112,33,79,2,0,0,0,14,9,5,0
"2011","N00001745 (Woodburn ward)","N00001745",117,103,29,74,1,0,0,0,13,11,2,0
"2011","N00001746 (Woodburn ward)","N00001746",118,105,58,47,2,2,2,0,7,7,0,2
"2011","N00001747 (Woodburn ward)","N00001747",297,230,91,139,5,28,28,0,29,29,0,5
"2011","N00001748 (Woodburn ward)","N00001748",148,140,82,58,0,0,0,0,3,3,0,5
"2011","N00001749 (Woodburn ward)","N00001749",120,109,67,42,0,0,0,0,9,7,2,2
"2011","N00003067 (Antiville ward)","N00003067",131,104,73,31,0,6,6,0,17,17,0,4
"2011","N00003068 (Antiville ward)","N00003068",113,55,28,27,0,19,7,12,36,32,4,3
"2011","N00003069 (Antiville ward)","N00003069",113,51,27,24,2,40,39,1,17,13,4,3
"2011","N00003070 (Antiville ward)","N00003070",123,60,26,34,0,46,45,1,9,7,2,8
"2011","N00003071 (Antiville ward)","N00003071",108,51,25,26,0,36,36,0,18,17,1,3
"2011","N00003072 (Antiville ward)","N00003072",119,65,35,30,0,16,2,14,38,36,2,0
"2011","N00003073 (Ballycarry ward)","N00003073",139,126,76,50,0,1,1,0,11,9,2,1
"2011","N00003074 (Ballycarry ward)","N00003074",193,170,77,93,1,2,2,0,16,15,1,4
"2011","N00003075 (Ballycarry ward)","N00003075",114,104,62,42,2,0,0,0,6,6,0,2
"2011","N00003076 (Ballycarry ward)","N00003076",202,157,58,99,2,5,5,0,34,30,4,4
"2011","N00003077 (Ballycarry ward)","N00003077",142,99,34,65,2,20,20,0,17,17,0,4
"2011","N00003078 (Ballycarry ward)","N00003078",206,186,73,113,3,0,0,0,16,16,0,1
"2011","N00003079 (Ballyloran ward)","N00003079",135,65,34,31,1,43,43,0,23,20,3,3
"2011","N00003080 (Ballyloran ward)","N00003080",105,61,27,34,1,22,21,1,16,16,0,5
"2011","N00003081 (Ballyloran ward)","N00003081",62,20,8,12,1,33,33,0,5,4,1,3
"2011","N00003082 (Ballyloran ward)","N00003082",105,65,38,27,1,28,28,0,9,9,0,2
"2011","N00003083 (Ballyloran ward)","N00003083",100,57,23,34,1,29,29,0,6,6,0,7
"2011","N00003084 (Blackcave ward)","N00003084",130,81,32,49,2,22,22,0,22,19,3,3
"2011","N00003085 (Blackcave ward)","N00003085",123,57,29,28,3,37,36,1,17,15,2,9
"2011","N00003086 (Blackcave ward)","N00003086",120,57,20,37,1,45,45,0,10,10,0,7
"2011","N00003087 (Blackcave ward)","N00003087",139,102,65,37,1,31,31,0,5,4,1,0
"2011","N00003088 (Blackcave ward)","N00003088",65,16,7,9,1,38,38,0,9,9,0,1
"2011","N00003089 (Blackcave ward)","N00003089",115,93,36,57,0,6,6,0,16,16,0,0
"2011","N00003090 (Carncastle ward)","N00003090",139,127,53,74,0,2,2,0,10,9,1,0
"2011","N00003091 (Carncastle ward)","N00003091",142,128,43,85,0,0,0,0,12,10,2,2
"2011","N00003092 (Carncastle ward)","N00003092",98,69,34,35,2,13,13,0,12,10,2,2
"2011","N00003093 (Carncastle ward)","N00003093",181,170,74,96,0,0,0,0,10,7,3,1
"2011","N00003094 (Carncastle ward)","N00003094",114,102,74,28,2,1,1,0,6,5,1,3
"2011","N00003095 (Carncastle ward)","N00003095",132,116,72,44,0,1,1,0,11,11,0,4
"2011","N00003096 (Carncastle ward)","N00003096",122,98,65,33,0,0,0,0,21,20,1,3
"2011","N00003097 (Carncastle ward)","N00003097",199,188,98,90,1,1,0,1,7,6,1,2
"2011","N00003098 (Carnlough ward)","N00003098",265,153,50,103,0,48,41,7,59,52,7,5
"2011","N00003099 (Carnlough ward)","N00003099",116,90,69,21,0,3,3,0,20,17,3,3
"2011","N00003100 (Carnlough ward)","N00003100",140,96,60,36,1,1,1,0,38,32,6,4
"2011","N00003101 (Carnlough ward)","N00003101",115,73,46,27,1,26,22,4,12,9,3,3
"2011","N00003102 (Carnlough ward)","N00003102",118,102,72,30,1,1,1,0,10,9,1,4
"2011","N00003103 (Central ward)","N00003103",127,93,64,29,1,2,2,0,30,30,0,1
"2011","N00003104 (Central ward)","N00003104",89,53,35,18,1,4,2,2,31,29,2,0
"2011","N00003105 (Central ward)","N00003105",238,69,41,28,0,99,24,75,63,59,4,7
"2011","N00003106 (Central ward)","N00003106",106,45,28,17,0,23,19,4,36,33,3,2
"2011","N00003107 (Central ward)","N00003107",140,25,12,13,0,89,88,1,20,18,2,6
"2011","N00003108 (Central ward)","N00003108",99,61,23,38,1,14,3,11,19,17,2,4
"2011","N00003109 (Central ward)","N00003109",120,99,55,44,0,2,1,1,17,14,3,2
"2011","N00003110 (Craigy Hill ward)","N00003110",115,64,39,25,2,35,35,0,10,7,3,4
"2011","N00003111 (Craigy Hill ward)","N00003111",95,44,26,18,1,37,35,2,7,7,0,6
"2011","N00003112 (Craigy Hill ward)","N00003112",107,71,34,37,0,27,27,0,7,7,0,2
"2011","N00003113 (Craigy Hill ward)","N00003113",114,77,43,34,0,24,24,0,8,8,0,5
"2011","N00003114 (Craigy Hill ward)","N00003114",158,76,44,32,1,56,56,0,16,12,4,9
"2011","N00003115 (Craigy Hill ward)","N00003115",109,67,35,32,0,27,26,1,12,12,0,3
"2011","N00003116 (Gardenmore ward)","N00003116",114,92,58,34,0,13,3,10,7,6,1,2
"2011","N00003117 (Gardenmore ward)","N00003117",120,93,59,34,0,7,2,5,20,16,4,0
"2011","N00003118 (Gardenmore ward)","N00003118",116,40,28,12,0,48,15,33,23,20,3,5
"2011","N00003119 (Gardenmore ward)","N00003119",110,51,26,25,2,29,16,13,24,22,2,4
"2011","N00003120 (Gardenmore ward)","N00003120",128,121,66,55,0,0,0,0,7,5,2,0
"2011","N00003121 (Gardenmore ward)","N00003121",129,112,66,46,1,2,1,1,11,8,3,3
"2011","N00003122 (Gardenmore ward)","N00003122",121,115,83,32,0,1,0,1,4,3,1,1
"2011","N00003123 (Glenarm ward)","N00003123",128,113,73,40,1,1,1,0,9,8,1,4
"2011","N00003124 (Glenarm ward)","N00003124",141,70,33,37,1,22,3,19,45,36,9,3
"2011","N00003125 (Glenarm ward)","N00003125",118,75,51,24,0,15,14,1,20,18,2,8
"2011","N00003126 (Glenarm ward)","N00003126",154,124,70,54,1,2,2,0,17,16,1,10
"2011","N00003127 (Glenarm ward)","N00003127",147,131,87,44,0,1,0,1,12,10,2,3
"2011","N00003128 (Glynn ward)","N00003128",134,86,49,37,1,25,24,1,12,10,2,10
"2011","N00003129 (Glynn ward)","N00003129",122,112,64,48,0,0,0,0,7,6,1,3
"2011","N00003130 (Glynn ward)","N00003130",118,104,57,47,1,5,5,0,6,4,2,2
"2011","N00003131 (Glynn ward)","N00003131",277,252,151,101,0,1,1,0,18,17,1,6
"2011","N00003132 (Glynn ward)","N00003132",125,107,53,54,3,1,1,0,14,12,2,0
"2011","N00003133 (Harbour ward)","N00003133",152,126,77,49,0,4,4,0,18,18,0,4
"2011","N00003134 (Harbour ward)","N00003134",134,76,44,32,0,4,4,0,50,49,1,4
"2011","N00003135 (Harbour ward)","N00003135",65,39,15,24,1,15,15,0,9,8,1,1
"2011","N00003136 (Harbour ward)","N00003136",168,107,50,57,1,7,7,0,50,44,6,3
"2011","N00003137 (Harbour ward)","N00003137",114,85,45,40,0,2,1,1,22,20,2,5
"2011","N00003138 (Harbour ward)","N00003138",125,79,54,25,0,22,22,0,20,20,0,4
"2011","N00003139 (Island Magee ward)","N00003139",160,141,69,72,0,0,0,0,17,13,4,2
"2011","N00003140 (Island Magee ward)","N00003140",134,107,50,57,0,8,8,0,16,15,1,3
"2011","N00003141 (Island Magee ward)","N00003141",149,124,81,43,0,1,1,0,17,15,2,7
"2011","N00003142 (Island Magee ward)","N00003142",337,298,110,188,0,3,3,0,36,28,8,0
"2011","N00003143 (Island Magee ward)","N00003143",126,70,26,44,0,34,33,1,21,16,5,1
"2011","N00003144 (Island Magee ward)","N00003144",125,102,55,47,0,7,7,0,11,9,2,5
"2011","N00003145 (Kilwaughter ward)","N00003145",549,371,66,305,9,7,4,3,161,159,2,1
"2011","N00003146 (Kilwaughter ward)","N00003146",155,119,18,101,3,0,0,0,31,28,3,2
"2011","N00003147 (Kilwaughter ward)","N00003147",342,296,48,248,1,2,2,0,42,40,2,1
"2011","N00003148 (Kilwaughter ward)","N00003148",116,102,26,76,0,2,1,1,12,9,3,0
"2011","N00003149 (Kilwaughter ward)","N00003149",204,175,37,138,0,1,1,0,27,22,5,1
"2011","N00003150 (Kilwaughter ward)","N00003150",130,115,75,40,0,0,0,0,13,11,2,2
"2011","N00003151 (Kilwaughter ward)","N00003151",130,87,36,51,0,21,21,0,19,18,1,3
"2011","N00003152 (Kilwaughter ward)","N00003152",157,129,75,54,0,2,2,0,20,20,0,6
"2011","N00003153 (Kilwaughter ward)","N00003153",129,120,68,52,0,1,1,0,5,4,1,3
"2011","N00003154 (Kilwaughter ward)","N00003154",133,125,76,49,0,0,0,0,5,5,0,3
"2011","N00003155 (Town Parks ward)","N00003155",125,75,41,34,1,11,9,2,33,32,1,5
"2011","N00003156 (Town Parks ward)","N00003156",115,74,38,36,4,9,2,7,28,26,2,0
"2011","N00003157 (Town Parks ward)","N00003157",113,89,52,37,0,0,0,0,24,23,1,0
"2011","N00003158 (Town Parks ward)","N00003158",124,81,57,24,1,0,0,0,39,34,5,3
"2011","N00003159 (Town Parks ward)","N00003159",165,129,64,65,5,2,1,1,27,24,3,2
"2011","N00003160 (Town Parks ward)","N00003160",119,67,42,25,0,25,25,0,21,18,3,6
"2011","N00002090 (Ardboe ward)","N00002090",154,136,71,65,0,3,3,0,6,5,1,9
"2011","N00002091 (Ardboe ward)","N00002091",314,286,162,124,0,5,4,1,20,12,8,3
"2011","N00002092 (Ardboe ward)","N00002092",177,130,58,72,0,16,7,9,27,25,2,4
"2011","N00002093 (Ardboe ward)","N00002093",191,159,84,75,0,12,12,0,17,17,0,3
"2011","N00002094 (Coagh ward)","N00002094",277,188,93,95,0,47,39,8,38,29,9,4
"2011","N00002095 (Coagh ward)","N00002095",155,136,79,57,0,9,8,1,7,5,2,3
"2011","N00002096 (Coagh ward)","N00002096",161,137,88,49,0,3,3,0,14,14,0,7
"2011","N00002097 (Coagh ward)","N00002097",129,114,65,49,0,1,1,0,10,6,4,4
"2011","N00002098 (Dunnamore ward)","N00002098",132,122,82,40,0,0,0,0,6,5,1,4
"2011","N00002099 (Dunnamore ward)","N00002099",139,124,76,48,0,4,4,0,8,8,0,3
"2011","N00002100 (Dunnamore ward)","N00002100",147,130,66,64,1,1,1,0,10,9,1,5
"2011","N00002101 (Dunnamore ward)","N00002101",153,133,70,63,0,0,0,0,13,12,1,7
"2011","N00002102 (Dunnamore ward)","N00002102",133,117,69,48,0,1,1,0,12,12,0,3
"2011","N00002103 (Gortalowry ward)","N00002103",267,174,65,109,0,30,29,1,60,58,2,3
"2011","N00002104 (Gortalowry ward)","N00002104",114,59,30,29,0,9,8,1,40,38,2,6
"2011","N00002105 (Gortalowry ward)","N00002105",149,88,32,56,2,24,23,1,30,29,1,5
"2011","N00002106 (Gortalowry ward)","N00002106",118,88,35,53,0,3,2,1,24,21,3,3
"2011","N00002107 (Gortalowry ward)","N00002107",172,112,40,72,2,19,19,0,33,32,1,6
"2011","N00002108 (Gortalowry ward)","N00002108",154,66,10,56,2,59,59,0,21,20,1,6
"2011","N00002109 (Killycolpy ward)","N00002109",162,139,80,59,1,1,1,0,18,16,2,3
"2011","N00002110 (Killycolpy ward)","N00002110",175,122,51,71,2,20,20,0,27,25,2,4
"2011","N00002111 (Killycolpy ward)","N00002111",155,138,83,55,0,1,1,0,13,10,3,3
"2011","N00002112 (Killycolpy ward)","N00002112",144,126,60,66,0,6,6,0,11,10,1,1
"2011","N00002113 (Killycolpy ward)","N00002113",167,145,76,69,0,1,1,0,18,14,4,3
"2011","N00002114 (Killymoon ward)","N00002114",145,96,68,28,2,15,15,0,29,27,2,3
"2011","N00002115 (Killymoon ward)","N00002115",111,67,43,24,0,17,17,0,25,22,3,2
"2011","N00002116 (Killymoon ward)","N00002116",118,61,25,36,0,41,41,0,14,14,0,2
"2011","N00002117 (Killymoon ward)","N00002117",119,97,48,49,1,2,2,0,17,15,2,2
"2011","N00002118 (Killymoon ward)","N00002118",135,90,35,55,8,5,5,0,31,31,0,1
"2011","N00002119 (Killymoon ward)","N00002119",109,36,12,24,3,52,52,0,13,12,1,5
"2011","N00002120 (Lissan ward)","N00002120",110,89,67,22,0,6,6,0,14,14,0,1
"2011","N00002121 (Lissan ward)","N00002121",149,135,79,56,0,1,1,0,6,4,2,7
"2011","N00002122 (Lissan ward)","N00002122",157,139,73,66,0,0,0,0,14,12,2,4
"2011","N00002123 (Lissan ward)","N00002123",148,136,91,45,1,0,0,0,9,7,2,2
"2011","N00002124 (Lissan ward)","N00002124",118,88,54,34,0,12,1,11,14,13,1,4
"2011","N00002125 (Moneymore ward)","N00002125",481,346,169,177,2,36,35,1,79,70,9,18
"2011","N00002126 (Moneymore ward)","N00002126",170,124,48,76,1,8,8,0,34,28,6,3
"2011","N00002127 (Moneymore ward)","N00002127",316,183,85,98,4,7,7,0,117,112,5,5
"2011","N00002128 (Newbuildings ward)","N00002128",321,229,123,106,0,15,15,0,71,65,6,6
"2011","N00002129 (Newbuildings ward)","N00002129",460,203,103,100,2,108,66,42,130,118,12,17
"2011","N00002130 (Newbuildings ward)","N00002130",166,81,57,24,2,10,9,1,72,64,8,1
"2011","N00002131 (Oaklands ward)","N00002131",136,122,75,47,0,0,0,0,9,8,1,5
"2011","N00002132 (Oaklands ward)","N00002132",111,96,51,45,0,3,3,0,7,6,1,5
"2011","N00002133 (Oaklands ward)","N00002133",172,152,95,57,0,2,2,0,13,13,0,5
"2011","N00002134 (Oaklands ward)","N00002134",121,95,67,28,2,5,5,0,13,10,3,6
"2011","N00002135 (Oaklands ward)","N00002135",159,146,83,63,0,1,1,0,9,5,4,3
"2011","N00002136 (Oldtown ward)","N00002136",149,53,20,33,0,31,31,0,59,58,1,6
"2011","N00002137 (Oldtown ward)","N00002137",112,75,39,36,1,29,29,0,6,6,0,1
"2011","N00002138 (Oldtown ward)","N00002138",132,88,57,31,1,18,18,0,22,19,3,3
"2011","N00002139 (Oldtown ward)","N00002139",245,141,47,94,5,14,5,9,84,78,6,1
"2011","N00002140 (Oldtown ward)","N00002140",113,101,72,29,0,2,2,0,8,7,1,2
"2011","N00002141 (Oldtown ward)","N00002141",120,64,32,32,0,40,40,0,10,10,0,6
"2011","N00002142 (Oldtown ward)","N00002142",111,49,29,20,3,44,44,0,14,14,0,1
"2011","N00002143 (Pomeroy ward)","N00002143",146,118,55,63,0,6,6,0,19,16,3,3
"2011","N00002144 (Pomeroy ward)","N00002144",190,140,70,70,0,4,4,0,40,34,6,6
"2011","N00002145 (Pomeroy ward)","N00002145",144,120,73,47,2,3,3,0,15,11,4,4
"2011","N00002146 (Pomeroy ward)","N00002146",143,113,73,40,0,5,5,0,18,15,3,7
"2011","N00002147 (Pomeroy ward)","N00002147",153,82,26,56,0,32,32,0,35,31,4,4
"2011","N00002148 (Sandholes ward)","N00002148",134,123,84,39,0,1,0,1,3,3,0,7
"2011","N00002149 (Sandholes ward)","N00002149",143,120,66,54,0,6,6,0,11,9,2,6
"2011","N00002150 (Sandholes ward)","N00002150",133,112,70,42,0,2,2,0,15,13,2,4
"2011","N00002151 (Sandholes ward)","N00002151",103,76,49,27,0,8,8,0,16,14,2,3
"2011","N00002152 (Sandholes ward)","N00002152",129,84,52,32,2,23,23,0,15,11,4,5
"2011","N00002153 (Stewartstown ward)","N00002153",143,126,82,44,0,2,2,0,8,6,2,7
"2011","N00002154 (Stewartstown ward)","N00002154",132,113,76,37,0,5,5,0,13,10,3,1
"2011","N00002155 (Stewartstown ward)","N00002155",152,133,83,50,0,1,1,0,13,11,2,5
"2011","N00002156 (Stewartstown ward)","N00002156",143,77,39,38,3,21,19,2,30,30,0,12
"2011","N00002157 (Stewartstown ward)","N00002157",133,54,30,24,0,55,55,0,22,21,1,2
"2011","N00002158 (The Loop ward)","N00002158",139,128,86,42,0,1,1,0,10,6,4,0
"2011","N00002159 (The Loop ward)","N00002159",160,136,72,64,0,3,3,0,16,15,1,5
"2011","N00002160 (The Loop ward)","N00002160",125,104,66,38,1,0,0,0,16,16,0,4
"2011","N00002161 (The Loop ward)","N00002161",148,126,78,48,0,1,0,1,16,14,2,5
"2011","N00002162 (The Loop ward)","N00002162",143,106,57,49,2,8,8,0,21,20,1,6
"2011","N00002163 (The Loop ward)","N00002163",206,138,44,94,3,8,8,0,55,50,5,2
"2011","N00002164 (Tullagh ward)","N00002164",126,76,35,41,1,20,19,1,26,25,1,3
"2011","N00002165 (Tullagh ward)","N00002165",118,93,36,57,2,0,0,0,23,17,6,0
"2011","N00002166 (Tullagh ward)","N00002166",123,99,63,36,0,2,2,0,22,18,4,0
"2011","N00002167 (Tullagh ward)","N00002167",149,77,49,28,2,24,1,23,42,39,3,4
"2011","N00002168 (Tullagh ward)","N00002168",110,84,47,37,4,0,0,0,20,16,4,2
"2011","N00002169 (Tullagh ward)","N00002169",183,97,48,49,0,12,5,7,66,60,6,8
"2011","N00002792 (Altmore ward)","N00002792",147,131,84,47,1,0,0,0,9,8,1,6
"2011","N00002793 (Altmore ward)","N00002793",164,127,64,63,0,11,10,1,16,13,3,10
"2011","N00002794 (Altmore ward)","N00002794",165,144,89,55,1,2,2,0,15,14,1,3
"2011","N00002795 (Altmore ward)","N00002795",159,142,82,60,0,1,1,0,12,9,3,4
"2011","N00002796 (Altmore ward)","N00002796",174,152,76,76,1,1,0,1,14,12,2,6
"2011","N00002797 (Augher ward)","N00002797",159,145,99,46,0,0,0,0,12,8,4,2
"2011","N00002798 (Augher ward)","N00002798",133,112,73,39,0,0,0,0,14,13,1,7
"2011","N00002799 (Augher ward)","N00002799",122,67,50,17,0,31,30,1,20,19,1,4
"2011","N00002800 (Augher ward)","N00002800",134,103,72,31,1,10,8,2,15,11,4,5
"2011","N00002801 (Augher ward)","N00002801",155,137,86,51,0,1,1,0,12,4,8,5
"2011","N00002802 (Aughnacloy ward)","N00002802",143,133,80,53,0,0,0,0,8,6,2,2
"2011","N00002803 (Aughnacloy ward)","N00002803",174,121,63,58,0,4,2,2,42,39,3,7
"2011","N00002804 (Aughnacloy ward)","N00002804",153,72,44,28,1,32,30,2,46,44,2,2
"2011","N00002805 (Aughnacloy ward)","N00002805",161,95,66,29,0,34,20,14,31,27,4,1
"2011","N00002806 (Aughnacloy ward)","N00002806",157,141,74,67,0,9,5,4,2,1,1,5
"2011","N00002807 (Aughnacloy ward)","N00002807",126,114,63,51,0,0,0,0,10,10,0,2
"2011","N00002808 (Ballygawley ward)","N00002808",166,144,88,56,0,1,1,0,19,16,3,2
"2011","N00002809 (Ballygawley ward)","N00002809",155,134,89,45,0,2,2,0,16,14,2,3
"2011","N00002810 (Ballygawley ward)","N00002810",129,69,44,25,0,28,27,1,20,15,5,12
"2011","N00002811 (Ballygawley ward)","N00002811",132,87,47,40,0,5,5,0,40,33,7,0
"2011","N00002812 (Ballygawley ward)","N00002812",135,116,79,37,0,3,3,0,10,9,1,6
"2011","N00002813 (Ballygawley ward)","N00002813",160,99,39,60,0,25,25,0,31,28,3,5
"2011","N00002814 (Ballysaggart ward)","N00002814",168,74,40,34,1,50,35,15,37,35,2,6
"2011","N00002815 (Ballysaggart ward)","N00002815",133,25,12,13,0,81,80,1,25,21,4,2
"2011","N00002816 (Ballysaggart ward)","N00002816",151,93,53,40,0,20,16,4,35,32,3,3
"2011","N00002817 (Ballysaggart ward)","N00002817",213,93,21,72,2,45,44,1,72,66,6,1
"2011","N00002818 (Ballysaggart ward)","N00002818",190,59,33,26,1,58,57,1,66,58,8,6
"2011","N00002819 (Ballysaggart ward)","N00002819",166,61,21,40,2,57,31,26,41,37,4,5
"2011","N00002820 (Benburb ward)","N00002820",187,160,88,72,0,2,2,0,20,18,2,5
"2011","N00002821 (Benburb ward)","N00002821",148,129,76,53,0,0,0,0,10,9,1,9
"2011","N00002822 (Benburb ward)","N00002822",136,95,38,57,0,7,6,1,34,33,1,0
"2011","N00002823 (Benburb ward)","N00002823",137,92,53,39,1,14,14,0,27,23,4,3
"2011","N00002824 (Benburb ward)","N00002824",129,95,61,34,1,25,25,0,6,5,1,2
"2011","N00002825 (Benburb ward)","N00002825",204,161,91,70,1,0,0,0,38,32,6,4
"2011","N00002826 (Caledon ward)","N00002826",141,121,77,44,0,6,6,0,12,8,4,2
"2011","N00002827 (Caledon ward)","N00002827",140,109,64,45,0,6,6,0,19,15,4,6
"2011","N00002828 (Caledon ward)","N00002828",144,64,27,37,0,38,37,1,35,34,1,7
"2011","N00002829 (Caledon ward)","N00002829",144,117,67,50,0,2,2,0,15,13,2,10
"2011","N00002830 (Caledon ward)","N00002830",136,115,63,52,1,2,2,0,16,12,4,2
"2011","N00002831 (Caledon ward)","N00002831",149,135,77,58,0,1,1,0,7,5,2,6
"2011","N00002832 (Castlecaulfield ward)","N00002832",132,117,48,69,1,0,0,0,12,10,2,2
"2011","N00002833 (Castlecaulfield ward)","N00002833",146,122,67,55,0,11,7,4,10,10,0,3
"2011","N00002834 (Castlecaulfield ward)","N00002834",170,150,86,64,0,0,0,0,17,14,3,3
"2011","N00002835 (Castlecaulfield ward)","N00002835",156,127,69,58,1,3,3,0,21,17,4,4
"2011","N00002836 (Castlecaulfield ward)","N00002836",149,122,79,43,1,5,5,0,16,16,0,5
"2011","N00002837 (Castlecaulfield ward)","N00002837",134,92,47,45,1,8,7,1,28,24,4,5
"2011","N00002838 (Clogher ward)","N00002838",149,130,81,49,0,1,1,0,14,12,2,4
"2011","N00002839 (Clogher ward)","N00002839",127,98,73,25,0,5,5,0,17,14,3,7
"2011","N00002840 (Clogher ward)","N00002840",468,335,189,146,3,48,48,0,64,55,9,18
"2011","N00002841 (Coalisland North ward)","N00002841",160,124,65,59,1,8,6,2,21,16,5,6
"2011","N00002842 (Coalisland North ward)","N00002842",206,132,50,82,0,22,22,0,48,44,4,4
"2011","N00002843 (Coalisland North ward)","N00002843",123,89,37,52,0,6,6,0,21,17,4,7
"2011","N00002844 (Coalisland North ward)","N00002844",126,52,26,26,0,53,51,2,17,15,2,4
"2011","N00002845 (Coalisland North ward)","N00002845",143,68,33,35,0,42,39,3,31,26,5,2
"2011","N00002846 (Coalisland North ward)","N00002846",197,116,27,89,2,10,3,7,69,64,5,0
"2011","N00002847 (Coalisland North ward)","N00002847",208,164,69,95,0,5,5,0,34,28,6,5
"2011","N00002848 (Coalisland South ward)","N00002848",444,274,110,164,1,76,72,4,80,74,6,13
"2011","N00002849 (Coalisland South ward)","N00002849",98,17,7,10,0,58,11,47,20,20,0,3
"2011","N00002850 (Coalisland South ward)","N00002850",130,57,28,29,0,40,39,1,27,24,3,6
"2011","N00002851 (Coalisland South ward)","N00002851",154,74,27,47,3,33,30,3,38,32,6,6
"2011","N00002852 (Coalisland South ward)","N00002852",130,79,34,45,0,9,6,3,39,38,1,3
"2011","N00002853 (Coalisland West and Newmills ward)","N00002853",354,195,88,107,2,40,13,27,110,105,5,7
"2011","N00002854 (Coalisland West and Newmills ward)","N00002854",160,113,61,52,0,24,10,14,20,15,5,3
"2011","N00002855 (Coalisland West and Newmills ward)","N00002855",169,132,58,74,2,12,8,4,20,20,0,3
"2011","N00002856 (Coalisland West and Newmills ward)","N00002856",132,98,55,43,1,15,15,0,16,14,2,2
"2011","N00002857 (Coalisland West and Newmills ward)","N00002857",184,138,68,70,0,18,3,15,24,21,3,4
"2011","N00002858 (Coolhill ward)","N00002858",145,71,34,37,1,8,7,1,61,57,4,4
"2011","N00002859 (Coolhill ward)","N00002859",206,133,78,55,4,2,2,0,62,54,8,5
"2011","N00002860 (Coolhill ward)","N00002860",138,75,40,35,0,27,24,3,34,32,2,2
"2011","N00002861 (Coolhill ward)","N00002861",135,82,45,37,1,4,4,0,44,41,3,4
"2011","N00002862 (Coolhill ward)","N00002862",109,59,31,28,1,34,33,1,14,14,0,1
"2011","N00002863 (Coolhill ward)","N00002863",121,94,42,52,4,2,1,1,19,16,3,2
"2011","N00002864 (Coolhill ward)","N00002864",122,86,37,49,0,1,0,1,34,29,5,1
"2011","N00002865 (Donaghmore (Dungannon) ward)","N00002865",189,169,87,82,0,2,1,1,16,15,1,2
"2011","N00002866 (Donaghmore (Dungannon) ward)","N00002866",166,140,89,51,0,2,2,0,18,14,4,6
"2011","N00002867 (Donaghmore (Dungannon) ward)","N00002867",195,155,85,70,0,6,2,4,24,22,2,10
"2011","N00002868 (Donaghmore (Dungannon) ward)","N00002868",172,101,33,68,0,39,37,2,30,29,1,2
"2011","N00002869 (Donaghmore (Dungannon) ward)","N00002869",144,106,56,50,1,3,3,0,30,28,2,4
"2011","N00002870 (Drumglass ward)","N00002870",205,151,89,62,0,18,5,13,28,27,1,8
"2011","N00002871 (Drumglass ward)","N00002871",282,122,43,79,2,56,48,8,93,81,12,9
"2011","N00002872 (Drumglass ward)","N00002872",133,62,34,28,1,22,20,2,44,38,6,4
"2011","N00002873 (Drumglass ward)","N00002873",126,71,42,29,1,20,19,1,30,25,5,4
"2011","N00002874 (Drumglass ward)","N00002874",124,45,20,25,2,46,43,3,26,22,4,5
"2011","N00002875 (Fivemiletown ward)","N00002875",420,289,195,94,0,38,23,15,72,65,7,21
"2011","N00002876 (Fivemiletown ward)","N00002876",197,144,83,61,0,13,13,0,34,32,2,6
"2011","N00002877 (Fivemiletown ward)","N00002877",131,55,28,27,1,52,50,2,15,14,1,8
"2011","N00002878 (Fivemiletown ward)","N00002878",105,51,39,12,2,18,18,0,25,25,0,9
"2011","N00002879 (Killyman ward)","N00002879",154,136,74,62,0,1,0,1,13,12,1,4
"2011","N00002881 (Killyman ward)","N00002881",206,160,49,111,1,11,11,0,30,29,1,4
"2011","N00002883 (Killyman ward)","N00002883",178,129,64,65,0,14,14,0,30,24,6,5
"2011","N00002884 (Killyman ward)","N00002884",155,129,71,58,0,2,2,0,20,19,1,4
"2011","N00002885 (Killymeal ward)","N00002885",302,130,85,45,8,90,43,47,63,57,6,11
"2011","N00002886 (Killymeal ward)","N00002886",268,149,54,95,2,2,2,0,111,108,3,4
"2011","N00002887 (Killymeal ward)","N00002887",247,155,84,71,1,6,1,5,76,69,7,9
"2011","N00002888 (Killymeal ward)","N00002888",140,121,74,47,1,3,1,2,13,13,0,2
"2011","N00002889 (Killymeal ward)","N00002889",142,60,41,19,0,51,26,25,21,18,3,10
"2011","N00002890 (Moy ward)","N00002890",137,118,70,48,1,1,1,0,8,6,2,9
"2011","N00002891 (Moy ward)","N00002891",204,153,61,92,0,2,2,0,48,44,4,1
"2011","N00002893 (Moy ward)","N00002893",114,61,31,30,0,20,20,0,29,29,0,4
"2011","N00002894 (Moy ward)","N00002894",147,100,67,33,0,17,16,1,23,20,3,7
"2011","N00002895 (Moy ward)","N00002895",170,115,50,65,0,12,4,8,37,32,5,6
"2011","N00002896 (Moy ward)","N00002896",120,109,77,32,0,0,0,0,9,9,0,2
"2011","N00002897 (Moygashel ward)","N00002897",323,245,105,140,0,11,11,0,60,54,6,7
"2011","N00002898 (Moygashel ward)","N00002898",134,97,64,33,0,8,7,1,26,20,6,3
"2011","N00002899 (Moygashel ward)","N00002899",132,79,45,34,1,20,13,7,26,24,2,6
"2011","N00002900 (Moygashel ward)","N00002900",139,84,44,40,1,29,29,0,18,17,1,7
"2011","N00002901 (Moygashel ward)","N00002901",126,88,61,27,0,20,20,0,12,11,1,6
"2011","N00002902 (Mullaghmore ward)","N00002902",149,84,54,30,0,17,16,1,45,41,4,3
"2011","N00002903 (Mullaghmore ward)","N00002903",320,103,78,25,3,102,57,45,103,92,11,9
"2011","N00002904 (Mullaghmore ward)","N00002904",138,90,30,60,0,11,9,2,34,33,1,3
"2011","N00002905 (Mullaghmore ward)","N00002905",153,111,54,57,0,14,13,1,27,25,2,1
"2011","N00002906 (Mullaghmore ward)","N00002906",144,117,64,53,0,1,1,0,22,20,2,4
"2011","N00002907 (Washing Bay ward)","N00002907",186,162,77,85,1,1,1,0,14,14,0,8
"2011","N00002908 (Washing Bay ward)","N00002908",164,115,37,78,1,14,13,1,31,29,2,3
"2011","N00002909 (Washing Bay ward)","N00002909",173,160,78,82,0,1,1,0,7,6,1,5
"2011","N00002910 (Washing Bay ward)","N00002910",211,182,96,86,0,2,2,0,22,21,1,5
"2011","N00002911 (Washing Bay ward)","N00002911",222,192,91,101,1,3,2,1,18,14,4,8
"2011","N00003527 (Ballymaguigan ward)","N00003527",159,140,78,62,0,0,0,0,18,13,5,1
"2011","N00003528 (Ballymaguigan ward)","N00003528",280,247,152,95,1,0,0,0,23,18,5,9
"2011","N00003529 (Ballymaguigan ward)","N00003529",136,111,55,56,0,8,8,0,12,8,4,5
"2011","N00003530 (Ballymaguigan ward)","N00003530",138,125,75,50,0,4,3,1,6,6,0,3
"2011","N00003531 (Ballymaguigan ward)","N00003531",125,108,55,53,0,0,0,0,14,12,2,3
"2011","N00003532 (Bellaghy ward)","N00003532",143,125,74,51,0,0,0,0,9,4,5,9
"2011","N00003533 (Bellaghy ward)","N00003533",196,133,57,76,1,11,6,5,48,46,2,3
"2011","N00003534 (Bellaghy ward)","N00003534",109,76,44,32,0,3,3,0,28,22,6,2
"2011","N00003535 (Bellaghy ward)","N00003535",141,132,83,49,0,1,1,0,6,5,1,2
"2011","N00003536 (Bellaghy ward)","N00003536",149,130,76,54,0,3,3,0,8,5,3,8
"2011","N00003537 (Bellaghy ward)","N00003537",119,59,27,32,0,36,36,0,18,17,1,6
"2011","N00003538 (Castledawson ward)","N00003538",156,119,67,52,1,5,5,0,27,27,0,4
"2011","N00003539 (Castledawson ward)","N00003539",113,79,14,65,2,2,2,0,28,28,0,2
"2011","N00003540 (Castledawson ward)","N00003540",109,65,31,34,0,12,10,2,26,21,5,6
"2011","N00003541 (Castledawson ward)","N00003541",115,77,48,29,0,14,14,0,21,18,3,3
"2011","N00003542 (Castledawson ward)","N00003542",108,33,15,18,0,45,45,0,24,22,2,6
"2011","N00003543 (Castledawson ward)","N00003543",192,116,62,54,0,2,2,0,68,62,6,6
"2011","N00003544 (Castledawson ward)","N00003544",121,87,44,43,1,1,1,0,31,31,0,1
"2011","N00003545 (Castledawson ward)","N00003545",138,124,74,50,0,3,3,0,8,7,1,3
"2011","N00003546 (Castledawson ward)","N00003546",123,89,41,48,4,7,7,0,18,18,0,5
"2011","N00003547 (Draperstown ward)","N00003547",230,181,84,97,0,5,1,4,38,34,4,6
"2011","N00003548 (Draperstown ward)","N00003548",631,418,201,217,4,92,72,20,107,87,20,10
"2011","N00003549 (Draperstown ward)","N00003549",157,142,99,43,0,1,0,1,8,6,2,6
"2011","N00003550 (Glebe ward)","N00003550",145,121,59,62,0,0,0,0,18,17,1,6
"2011","N00003551 (Glebe ward)","N00003551",169,97,57,40,3,2,1,1,61,59,2,6
"2011","N00003552 (Glebe ward)","N00003552",178,103,60,43,2,1,1,0,66,64,2,6
"2011","N00003553 (Glebe ward)","N00003553",119,75,13,62,0,1,1,0,42,39,3,1
"2011","N00003554 (Glebe ward)","N00003554",91,33,10,23,0,48,44,4,6,5,1,4
"2011","N00003555 (Glebe ward)","N00003555",157,65,44,21,1,42,18,24,39,34,5,10
"2011","N00003556 (Glebe ward)","N00003556",270,110,47,63,1,74,71,3,76,70,6,9
"2011","N00003557 (Gulladuff ward)","N00003557",122,41,19,22,0,60,41,19,10,9,1,11
"2011","N00003558 (Gulladuff ward)","N00003558",154,128,78,50,0,8,8,0,9,7,2,9
"2011","N00003559 (Gulladuff ward)","N00003559",184,135,57,78,0,20,20,0,22,20,2,7
"2011","N00003560 (Gulladuff ward)","N00003560",157,141,82,59,0,1,1,0,10,9,1,5
"2011","N00003561 (Gulladuff ward)","N00003561",134,124,81,43,0,2,2,0,7,5,2,1
"2011","N00003562 (Gulladuff ward)","N00003562",135,114,40,74,2,2,2,0,15,15,0,2
"2011","N00003563 (Knockcloghrim ward)","N00003563",150,115,69,46,0,14,14,0,17,13,4,4
"2011","N00003564 (Knockcloghrim ward)","N00003564",127,98,54,44,0,0,0,0,27,24,3,2
"2011","N00003565 (Knockcloghrim ward)","N00003565",143,128,78,50,0,0,0,0,12,10,2,3
"2011","N00003566 (Knockcloghrim ward)","N00003566",165,156,104,52,0,2,2,0,4,3,1,3
"2011","N00003567 (Knockcloghrim ward)","N00003567",155,134,75,59,1,1,1,0,13,11,2,6
"2011","N00003568 (Knockcloghrim ward)","N00003568",134,118,71,47,0,4,4,0,8,8,0,4
"2011","N00003569 (Lecumpher ward)","N00003569",147,137,78,59,0,0,0,0,9,7,2,1
"2011","N00003570 (Lecumpher ward)","N00003570",153,143,73,70,1,1,1,0,7,6,1,1
"2011","N00003571 (Lecumpher ward)","N00003571",111,78,37,41,0,19,19,0,14,10,4,0
"2011","N00003572 (Lecumpher ward)","N00003572",154,135,90,45,0,2,2,0,17,16,1,0
"2011","N00003573 (Lecumpher ward)","N00003573",134,116,62,54,0,0,0,0,15,13,2,3
"2011","N00003574 (Lecumpher ward)","N00003574",152,126,71,55,0,4,4,0,19,15,4,3
"2011","N00003575 (Lower Glenshane ward)","N00003575",147,134,81,53,1,1,1,0,7,6,1,4
"2011","N00003576 (Lower Glenshane ward)","N00003576",153,143,89,54,0,2,2,0,6,5,1,2
"2011","N00003577 (Lower Glenshane ward)","N00003577",139,111,63,48,0,12,12,0,11,9,2,5
"2011","N00003578 (Lower Glenshane ward)","N00003578",157,144,92,52,0,0,0,0,10,6,4,3
"2011","N00003579 (Lower Glenshane ward)","N00003579",150,137,81,56,1,1,1,0,4,2,2,7
"2011","N00003580 (Lower Glenshane ward)","N00003580",128,116,65,51,0,2,2,0,8,8,0,2
"2011","N00003581 (Maghera ward)","N00003581",232,118,26,92,1,19,18,1,92,90,2,2
"2011","N00003582 (Maghera ward)","N00003582",199,103,41,62,2,26,24,2,56,48,8,12
"2011","N00003583 (Maghera ward)","N00003583",252,163,93,70,1,43,28,15,30,29,1,15
"2011","N00003584 (Maghera ward)","N00003584",117,60,30,30,0,33,33,0,18,15,3,6
"2011","N00003585 (Maghera ward)","N00003585",123,64,31,33,0,33,33,0,22,21,1,4
"2011","N00003586 (Maghera ward)","N00003586",133,49,31,18,0,30,26,4,47,42,5,7
"2011","N00003587 (Swatragh ward)","N00003587",141,125,80,45,0,0,0,0,11,10,1,5
"2011","N00003588 (Swatragh ward)","N00003588",170,155,94,61,0,4,1,3,4,4,0,7
"2011","N00003589 (Swatragh ward)","N00003589",177,136,75,61,0,7,7,0,25,21,4,9
"2011","N00003590 (Swatragh ward)","N00003590",171,148,73,75,0,4,4,0,15,14,1,4
"2011","N00003591 (Swatragh ward)","N00003591",163,132,79,53,0,10,10,0,13,10,3,8
"2011","N00003592 (Swatragh ward)","N00003592",123,87,56,31,1,13,13,0,16,13,3,6
"2011","N00003593 (Tobermore ward)","N00003593",171,160,93,67,0,0,0,0,8,6,2,3
"2011","N00003594 (Tobermore ward)","N00003594",323,242,123,119,1,39,39,0,33,29,4,8
"2011","N00003595 (Tobermore ward)","N00003595",130,102,50,52,1,5,5,0,21,21,0,1
"2011","N00003596 (Tobermore ward)","N00003596",118,94,70,24,2,10,8,2,8,8,0,4
"2011","N00003597 (Tobermore ward)","N00003597",156,145,103,42,0,0,0,0,6,6,0,5
"2011","N00003598 (Town Parks East ward)","N00003598",129,104,33,71,0,1,1,0,23,22,1,1
"2011","N00003599 (Town Parks East ward)","N00003599",152,110,61,49,0,13,13,0,22,21,1,7
"2011","N00003600 (Town Parks East ward)","N00003600",137,55,20,35,3,49,49,0,28,23,5,2
"2011","N00003601 (Town Parks East ward)","N00003601",134,100,54,46,1,3,3,0,27,24,3,3
"2011","N00003602 (Town Parks East ward)","N00003602",144,61,15,46,1,29,28,1,46,46,0,7
"2011","N00003603 (Town Parks East ward)","N00003603",124,97,40,57,2,3,2,1,22,21,1,0
"2011","N00003604 (Town Parks East ward)","N00003604",154,76,50,26,0,15,15,0,59,55,4,4
"2011","N00003605 (Town Parks East ward)","N00003605",133,28,18,10,1,63,63,0,29,26,3,12
"2011","N00003606 (Town Parks West ward)","N00003606",118,94,47,47,1,2,2,0,21,19,2,0
"2011","N00003607 (Town Parks West ward)","N00003607",174,145,72,73,1,5,4,1,22,17,5,1
"2011","N00003608 (Town Parks West ward)","N00003608",170,115,46,69,1,10,8,2,40,34,6,4
"2011","N00003609 (Town Parks West ward)","N00003609",127,66,46,20,0,33,33,0,23,23,0,5
"2011","N00003610 (Town Parks West ward)","N00003610",122,71,44,27,0,32,32,0,10,10,0,9
"2011","N00003611 (Town Parks West ward)","N00003611",119,52,30,22,0,38,16,22,24,23,1,5
"2011","N00003612 (Upperlands ward)","N00003612",142,121,64,57,1,1,1,0,11,9,2,8
"2011","N00003613 (Upperlands ward)","N00003613",161,117,67,50,0,16,16,0,14,12,2,14
"2011","N00003614 (Upperlands ward)","N00003614",152,135,69,66,1,2,2,0,11,10,1,3
"2011","N00003615 (Upperlands ward)","N00003615",128,94,48,46,1,11,9,2,19,17,2,3
"2011","N00003616 (Upperlands ward)","N00003616",125,91,51,40,1,12,12,0,7,5,2,14
"2011","N00003617 (Upperlands ward)","N00003617",125,77,39,38,2,27,27,0,12,12,0,7
"2011","N00003618 (Valley ward)","N00003618",138,116,71,45,0,10,9,1,9,7,2,3
"2011","N00003619 (Valley ward)","N00003619",136,104,70,34,0,10,9,1,12,12,0,10
"2011","N00003620 (Valley ward)","N00003620",168,138,74,64,1,7,6,1,19,17,2,3
"2011","N00003621 (Valley ward)","N00003621",146,118,61,57,0,0,0,0,25,24,1,3
"2011","N00003622 (Valley ward)","N00003622",166,150,88,62,0,0,0,0,12,9,3,4
"2011","N00003623 (Valley ward)","N00003623",112,61,25,36,1,29,27,2,16,11,5,5
"2011","N00000721 (Ballyward ward)","N00000721",154,130,72,58,0,0,0,0,17,16,1,7
"2011","N00000723 (Ballyward ward)","N00000723",145,130,75,55,0,0,0,0,11,9,2,4
"2011","N00000724 (Ballyward ward)","N00000724",160,142,84,58,0,3,3,0,10,8,2,5
"2011","N00000725 (Ballyward ward)","N00000725",165,129,65,64,1,8,8,0,24,23,1,3
"2011","N00000726 (Ballyward ward)","N00000726",137,120,70,50,0,0,0,0,14,6,8,3
"2011","N00002632 (Ardglass ward)","N00002632",148,62,26,36,2,63,36,27,15,12,3,6
"2011","N00002633 (Ardglass ward)","N00002633",177,107,53,54,2,4,4,0,63,58,5,1
"2011","N00002634 (Ardglass ward)","N00002634",122,106,74,32,0,1,1,0,14,12,2,1
"2011","N00002635 (Ardglass ward)","N00002635",137,69,34,35,1,38,38,0,26,20,6,3
"2011","N00002636 (Ardglass ward)","N00002636",138,101,53,48,0,14,13,1,18,12,6,5
"2011","N00002637 (Ardglass ward)","N00002637",170,139,69,70,0,8,7,1,19,15,4,4
"2011","N00002638 (Ardglass ward)","N00002638",165,134,74,60,1,8,7,1,17,16,1,5
"2011","N00002639 (Ardglass ward)","N00002639",144,87,47,40,1,7,6,1,47,45,2,2
"2011","N00002640 (Audleys Acre ward)","N00002640",133,125,81,44,0,1,0,1,6,4,2,1
"2011","N00002641 (Audleys Acre ward)","N00002641",132,113,31,82,0,4,2,2,15,14,1,0
"2011","N00002642 (Audleys Acre ward)","N00002642",172,166,86,80,0,1,1,0,4,4,0,1
"2011","N00002643 (Audleys Acre ward)","N00002643",131,124,64,60,0,0,0,0,6,6,0,1
"2011","N00002644 (Audleys Acre ward)","N00002644",134,56,28,28,1,52,52,0,20,15,5,5
"2011","N00002645 (Audleys Acre ward)","N00002645",134,89,45,44,1,23,3,20,19,15,4,2
"2011","N00002646 (Ballymaglave ward)","N00002646",173,90,46,44,1,28,13,15,51,43,8,3
"2011","N00002647 (Ballymaglave ward)","N00002647",299,213,76,137,5,39,14,25,34,31,3,8
"2011","N00002648 (Ballymaglave ward)","N00002648",94,50,31,19,0,0,0,0,37,35,2,7
"2011","N00002649 (Ballymaglave ward)","N00002649",145,129,58,71,0,1,1,0,10,8,2,5
"2011","N00002650 (Ballymaglave ward)","N00002650",124,57,18,39,0,40,40,0,22,21,1,5
"2011","N00002651 (Ballymaglave ward)","N00002651",167,153,66,87,1,0,0,0,12,10,2,1
"2011","N00002652 (Ballymaglave ward)","N00002652",131,50,19,31,0,67,65,2,7,7,0,7
"2011","N00002653 (Ballymote ward)","N00002653",184,123,54,69,1,10,10,0,44,39,5,6
"2011","N00002654 (Ballymote ward)","N00002654",109,76,47,29,0,7,7,0,24,19,5,2
"2011","N00002655 (Ballymote ward)","N00002655",155,39,23,16,2,53,52,1,50,47,3,11
"2011","N00002656 (Ballymote ward)","N00002656",261,118,19,99,1,64,61,3,64,61,3,14
"2011","N00002657 (Ballymote ward)","N00002657",146,80,39,41,2,24,24,0,36,30,6,4
"2011","N00002658 (Ballymote ward)","N00002658",169,83,18,65,1,35,35,0,46,42,4,4
"2011","N00002659 (Ballymote ward)","N00002659",151,30,9,21,4,84,84,0,28,24,4,5
"2011","N00002660 (Ballynahinch East ward)","N00002660",164,127,69,58,0,12,3,9,21,21,0,4
"2011","N00002661 (Ballynahinch East ward)","N00002661",232,99,43,56,1,98,82,16,27,22,5,7
"2011","N00002662 (Ballynahinch East ward)","N00002662",185,104,43,61,1,21,21,0,48,40,8,11
"2011","N00002663 (Ballynahinch East ward)","N00002663",127,96,31,65,4,5,5,0,21,18,3,1
"2011","N00002664 (Ballynahinch East ward)","N00002664",144,45,17,28,0,59,59,0,37,32,5,3
"2011","N00002665 (Ballynahinch East ward)","N00002665",114,97,48,49,1,1,1,0,14,11,3,1
"2011","N00002666 (Ballynahinch East ward)","N00002666",109,90,51,39,0,2,2,0,12,12,0,5
"2011","N00002667 (Castlewellan ward)","N00002667",334,198,112,86,1,51,48,3,75,67,8,9
"2011","N00002668 (Castlewellan ward)","N00002668",116,70,26,44,0,18,11,7,24,21,3,4
"2011","N00002669 (Castlewellan ward)","N00002669",187,152,88,64,0,3,3,0,28,26,2,4
"2011","N00002670 (Castlewellan ward)","N00002670",600,401,148,253,3,61,17,44,119,111,8,16
"2011","N00002671 (Cathedral ward)","N00002671",466,338,74,264,14,44,22,22,66,55,11,4
"2011","N00002672 (Cathedral ward)","N00002672",129,42,13,29,0,56,54,2,27,26,1,4
"2011","N00002673 (Cathedral ward)","N00002673",536,279,123,156,4,88,35,53,146,128,18,19
"2011","N00002674 (Cathedral ward)","N00002674",115,57,23,34,3,30,27,3,23,22,1,2
"2011","N00002675 (Crossgar ward)","N00002675",131,124,70,54,0,1,0,1,5,5,0,1
"2011","N00002676 (Crossgar ward)","N00002676",283,189,89,100,3,27,27,0,57,51,6,7
"2011","N00002677 (Crossgar ward)","N00002677",152,130,77,53,0,7,6,1,11,9,2,4
"2011","N00002678 (Crossgar ward)","N00002678",139,101,53,48,1,0,0,0,32,28,4,5
"2011","N00002679 (Crossgar ward)","N00002679",199,124,47,77,0,30,30,0,35,29,6,10
"2011","N00002680 (Crossgar ward)","N00002680",138,124,72,52,0,2,1,1,9,8,1,3
"2011","N00002681 (Crossgar ward)","N00002681",154,139,86,53,0,2,2,0,10,8,2,3
"2011","N00002682 (Derryboy ward)","N00002682",160,138,39,99,1,0,0,0,20,16,4,1
"2011","N00002683 (Derryboy ward)","N00002683",136,120,61,59,0,6,6,0,7,6,1,3
"2011","N00002684 (Derryboy ward)","N00002684",165,146,69,77,0,2,2,0,15,13,2,2
"2011","N00002685 (Derryboy ward)","N00002685",126,109,65,44,0,0,0,0,15,14,1,2
"2011","N00002686 (Derryboy ward)","N00002686",130,107,70,37,0,7,7,0,11,9,2,5
"2011","N00002687 (Derryboy ward)","N00002687",120,88,51,37,1,17,17,0,12,11,1,2
"2011","N00002688 (Derryboy ward)","N00002688",129,101,70,31,1,5,5,0,17,16,1,5
"2011","N00002689 (Derryboy ward)","N00002689",126,69,24,45,0,37,37,0,17,16,1,3
"2011","N00002690 (Donard ward)","N00002690",97,59,38,21,0,6,0,6,28,25,3,4
"2011","N00002691 (Donard ward)","N00002691",125,104,51,53,0,0,0,0,20,18,2,1
"2011","N00002692 (Donard ward)","N00002692",133,97,68,29,0,2,1,1,30,22,8,4
"2011","N00002693 (Donard ward)","N00002693",190,62,41,21,0,87,11,76,35,33,2,6
"2011","N00002694 (Donard ward)","N00002694",124,108,65,43,0,1,1,0,14,13,1,1
"2011","N00002695 (Donard ward)","N00002695",145,125,31,94,0,3,1,2,16,15,1,1
"2011","N00002696 (Donard ward)","N00002696",129,101,61,40,0,1,0,1,23,22,1,4
"2011","N00002697 (Donard ward)","N00002697",139,106,45,61,0,1,1,0,29,26,3,3
"2011","N00002698 (Donard ward)","N00002698",208,165,93,72,1,4,1,3,36,30,6,2
"2011","N00002699 (Drumaness ward)","N00002699",136,78,40,38,0,32,32,0,15,15,0,11
"2011","N00002700 (Drumaness ward)","N00002700",191,130,39,91,4,4,3,1,51,49,2,2
"2011","N00002701 (Drumaness ward)","N00002701",174,146,59,87,1,2,2,0,18,18,0,7
"2011","N00002702 (Drumaness ward)","N00002702",136,101,40,61,1,14,14,0,16,16,0,4
"2011","N00002703 (Drumaness ward)","N00002703",189,168,74,94,0,2,2,0,15,11,4,4
"2011","N00002704 (Drumaness ward)","N00002704",173,154,65,89,1,1,1,0,9,7,2,8
"2011","N00002705 (Drumaness ward)","N00002705",150,132,55,77,0,1,1,0,16,15,1,1
"2011","N00002706 (Drumaness ward)","N00002706",148,121,70,51,1,10,10,0,11,11,0,5
"2011","N00002707 (Dundrum ward)","N00002707",192,150,74,76,2,1,1,0,33,28,5,6
"2011","N00002708 (Dundrum ward)","N00002708",118,48,25,23,1,49,49,0,13,11,2,7
"2011","N00002709 (Dundrum ward)","N00002709",185,132,78,54,2,2,2,0,41,37,4,8
"2011","N00002710 (Dundrum ward)","N00002710",177,95,25,70,0,38,38,0,40,38,2,4
"2011","N00002711 (Dundrum ward)","N00002711",327,200,110,90,0,40,40,0,80,75,5,7
"2011","N00002712 (Dundrum ward)","N00002712",129,101,54,47,0,3,3,0,20,19,1,5
"2011","N00002713 (Dunmore ward)","N00002713",143,115,46,69,1,10,10,0,13,12,1,4
"2011","N00002714 (Dunmore ward)","N00002714",155,142,79,63,0,0,0,0,10,8,2,3
"2011","N00002715 (Dunmore ward)","N00002715",150,139,72,67,1,3,3,0,4,2,2,3
"2011","N00002716 (Dunmore ward)","N00002716",136,110,68,42,0,6,6,0,18,16,2,2
"2011","N00002717 (Dunmore ward)","N00002717",181,157,80,77,1,2,2,0,17,13,4,4
"2011","N00002718 (Dunmore ward)","N00002718",173,163,83,80,0,1,1,0,8,5,3,1
"2011","N00002719 (Dunmore ward)","N00002719",126,111,67,44,0,0,0,0,14,13,1,1
"2011","N00002720 (Killough ward)","N00002720",128,91,41,50,0,11,11,0,26,24,2,0
"2011","N00002721 (Killough ward)","N00002721",126,99,61,38,0,6,6,0,18,13,5,3
"2011","N00002722 (Killough ward)","N00002722",137,124,63,61,0,1,1,0,10,8,2,2
"2011","N00002723 (Killough ward)","N00002723",154,107,42,65,1,18,16,2,23,20,3,5
"2011","N00002724 (Killough ward)","N00002724",107,64,27,37,0,16,16,0,26,22,4,1
"2011","N00002725 (Killough ward)","N00002725",139,117,61,56,0,2,2,0,18,15,3,2
"2011","N00002726 (Killough ward)","N00002726",414,231,112,119,3,18,17,1,152,71,81,10
"2011","N00002727 (Killyleagh ward)","N00002727",129,111,50,61,2,2,1,1,11,9,2,3
"2011","N00002728 (Killyleagh ward)","N00002728",411,274,118,156,3,28,27,1,95,91,4,11
"2011","N00002729 (Killyleagh ward)","N00002729",122,46,16,30,0,56,54,2,17,17,0,3
"2011","N00002730 (Killyleagh ward)","N00002730",125,59,32,27,0,43,35,8,21,14,7,2
"2011","N00002731 (Killyleagh ward)","N00002731",126,57,20,37,0,48,48,0,21,18,3,0
"2011","N00002732 (Killyleagh ward)","N00002732",121,65,29,36,0,37,37,0,16,15,1,3
"2011","N00002733 (Killyleagh ward)","N00002733",196,106,58,48,0,9,9,0,76,72,4,5
"2011","N00002734 (Kilmore ward)","N00002734",156,137,46,91,0,1,0,1,16,15,1,2
"2011","N00002735 (Kilmore ward)","N00002735",137,118,72,46,0,1,1,0,15,13,2,3
"2011","N00002736 (Kilmore ward)","N00002736",126,117,78,39,0,1,1,0,7,7,0,1
"2011","N00002737 (Kilmore ward)","N00002737",128,115,77,38,0,2,2,0,8,5,3,3
"2011","N00002738 (Kilmore ward)","N00002738",148,126,77,49,0,1,1,0,14,13,1,7
"2011","N00002739 (Kilmore ward)","N00002739",138,123,72,51,0,4,4,0,8,5,3,3
"2011","N00002740 (Kilmore ward)","N00002740",136,109,54,55,4,2,2,0,19,17,2,2
"2011","N00002741 (Kilmore ward)","N00002741",159,125,55,70,0,7,6,1,23,19,4,4
"2011","N00002742 (Murlough ward)","N00002742",148,85,36,49,0,25,25,0,33,29,4,5
"2011","N00002743 (Murlough ward)","N00002743",159,101,65,36,0,5,5,0,48,42,6,5
"2011","N00002744 (Murlough ward)","N00002744",121,42,12,30,0,57,54,3,16,13,3,6
"2011","N00002745 (Murlough ward)","N00002745",136,67,28,39,1,45,36,9,14,12,2,9
"2011","N00002746 (Murlough ward)","N00002746",115,74,36,38,4,2,2,0,35,31,4,0
"2011","N00002747 (Murlough ward)","N00002747",121,89,71,18,0,2,1,1,27,23,4,3
"2011","N00002748 (Murlough ward)","N00002748",128,90,45,45,0,3,2,1,34,31,3,1
"2011","N00002749 (Quoile ward)","N00002749",138,88,39,49,0,7,7,0,43,40,3,0
"2011","N00002750 (Quoile ward)","N00002750",119,66,34,32,2,31,28,3,19,18,1,1
"2011","N00002751 (Quoile ward)","N00002751",154,57,31,26,0,28,19,9,66,66,0,3
"2011","N00002752 (Quoile ward)","N00002752",123,91,66,25,0,7,6,1,20,15,5,5
"2011","N00002753 (Quoile ward)","N00002753",181,151,55,96,1,6,2,4,20,17,3,3
"2011","N00002754 (Quoile ward)","N00002754",140,118,54,64,1,5,2,3,13,10,3,3
"2011","N00002755 (Quoile ward)","N00002755",168,149,67,82,0,0,0,0,17,14,3,2
"2011","N00002756 (Saintfield ward)","N00002756",131,121,77,44,0,1,1,0,9,8,1,0
"2011","N00002757 (Saintfield ward)","N00002757",203,140,57,83,3,21,19,2,31,25,6,8
"2011","N00002758 (Saintfield ward)","N00002758",115,73,35,38,1,27,27,0,8,8,0,6
"2011","N00002759 (Saintfield ward)","N00002759",125,89,29,60,0,16,16,0,12,11,1,8
"2011","N00002760 (Saintfield ward)","N00002760",112,93,34,59,1,0,0,0,16,14,2,2
"2011","N00002761 (Saintfield ward)","N00002761",380,290,123,167,3,6,1,5,71,64,7,10
"2011","N00002762 (Saintfield ward)","N00002762",132,122,78,44,0,2,2,0,5,2,3,3
"2011","N00002763 (Saintfield ward)","N00002763",138,119,81,38,0,1,1,0,14,13,1,4
"2011","N00002764 (Seaforde ward)","N00002764",160,126,65,61,0,12,2,10,18,17,1,4
"2011","N00002765 (Seaforde ward)","N00002765",148,120,71,49,0,2,2,0,16,14,2,10
"2011","N00002766 (Seaforde ward)","N00002766",162,148,71,77,1,2,1,1,8,7,1,3
"2011","N00002767 (Seaforde ward)","N00002767",135,114,57,57,1,1,1,0,16,13,3,3
"2011","N00002768 (Seaforde ward)","N00002768",146,86,41,45,1,28,22,6,26,23,3,5
"2011","N00002769 (Seaforde ward)","N00002769",173,143,80,63,0,4,4,0,18,17,1,8
"2011","N00002770 (Seaforde ward)","N00002770",149,128,68,60,0,1,1,0,15,14,1,5
"2011","N00002771 (Shimna ward)","N00002771",124,62,32,30,1,39,39,0,18,15,3,4
"2011","N00002772 (Shimna ward)","N00002772",140,102,72,30,0,1,0,1,32,31,1,5
"2011","N00002773 (Shimna ward)","N00002773",107,55,31,24,0,25,25,0,18,15,3,9
"2011","N00002774 (Shimna ward)","N00002774",220,188,84,104,2,4,4,0,22,20,2,4
"2011","N00002775 (Shimna ward)","N00002775",186,163,90,73,0,2,2,0,15,12,3,6
"2011","N00002776 (Shimna ward)","N00002776",124,105,62,43,1,0,0,0,14,13,1,4
"2011","N00002777 (Shimna ward)","N00002777",100,44,24,20,1,36,36,0,18,16,2,1
"2011","N00002778 (Shimna ward)","N00002778",150,73,58,15,2,2,2,0,70,64,6,3
"2011","N00002779 (Strangford ward)","N00002779",165,149,71,78,0,2,2,0,12,10,2,2
"2011","N00002780 (Strangford ward)","N00002780",165,107,74,33,1,23,18,5,25,23,2,9
"2011","N00002781 (Strangford ward)","N00002781",168,131,80,51,0,3,1,2,29,22,7,5
"2011","N00002782 (Strangford ward)","N00002782",174,136,72,64,0,11,11,0,23,17,6,4
"2011","N00002783 (Strangford ward)","N00002783",144,127,69,58,0,0,0,0,12,9,3,5
"2011","N00002784 (Strangford ward)","N00002784",187,149,72,77,0,8,8,0,26,25,1,4
"2011","N00002785 (Tollymore ward)","N00002785",222,165,77,88,3,12,11,1,40,36,4,2
"2011","N00002786 (Tollymore ward)","N00002786",154,131,76,55,0,0,0,0,20,19,1,3
"2011","N00002787 (Tollymore ward)","N00002787",137,118,77,41,0,6,1,5,9,9,0,4
"2011","N00002788 (Tollymore ward)","N00002788",132,113,71,42,0,4,4,0,15,12,3,0
"2011","N00002789 (Tollymore ward)","N00002789",193,107,40,67,3,28,28,0,54,53,1,1
"2011","N00002790 (Tollymore ward)","N00002790",163,132,61,71,1,14,14,0,13,10,3,3
"2011","N00002791 (Tollymore ward)","N00002791",158,124,70,54,0,0,0,0,31,25,6,3
"2011","N00003667 (Annalong ward)","N00003667",138,115,72,43,0,3,3,0,14,14,0,6
"2011","N00003668 (Annalong ward)","N00003668",146,111,68,43,0,8,7,1,24,22,2,3
"2011","N00003669 (Annalong ward)","N00003669",144,112,59,53,0,11,1,10,17,17,0,4
"2011","N00003670 (Annalong ward)","N00003670",135,108,67,41,0,2,2,0,17,14,3,8
"2011","N00003671 (Annalong ward)","N00003671",117,44,10,34,1,49,49,0,16,15,1,7
"2011","N00003672 (Annalong ward)","N00003672",118,89,49,40,3,6,6,0,18,14,4,2
"2011","N00003673 (Annalong ward)","N00003673",107,84,45,39,1,2,2,0,16,14,2,4
"2011","N00003674 (Annalong ward)","N00003674",141,101,39,62,7,1,0,1,27,23,4,5
"2011","N00003675 (Annalong ward)","N00003675",125,71,43,28,1,17,17,0,30,27,3,6
"2011","N00003676 (Ballybot ward)","N00003676",132,79,48,31,0,21,17,4,27,24,3,5
"2011","N00003677 (Ballybot ward)","N00003677",125,59,23,36,1,39,39,0,23,22,1,3
"2011","N00003678 (Ballybot ward)","N00003678",144,90,47,43,0,28,28,0,22,20,2,4
"2011","N00003679 (Ballybot ward)","N00003679",132,76,34,42,0,27,24,3,26,25,1,3
"2011","N00003680 (Ballybot ward)","N00003680",123,55,32,23,2,46,45,1,16,15,1,4
"2011","N00003681 (Ballybot ward)","N00003681",185,71,48,23,1,28,20,8,76,70,6,9
"2011","N00003682 (Ballybot ward)","N00003682",144,30,21,9,0,85,52,33,23,22,1,6
"2011","N00003683 (Bessbrook ward)","N00003683",156,88,36,52,0,20,20,0,45,41,4,3
"2011","N00003684 (Bessbrook ward)","N00003684",124,67,38,29,1,44,42,2,11,11,0,1
"2011","N00003685 (Bessbrook ward)","N00003685",131,106,45,61,0,9,9,0,11,10,1,5
"2011","N00003686 (Bessbrook ward)","N00003686",137,89,51,38,0,25,25,0,19,16,3,4
"2011","N00003687 (Bessbrook ward)","N00003687",161,129,73,56,0,13,11,2,16,15,1,3
"2011","N00003688 (Bessbrook ward)","N00003688",149,73,27,46,0,30,30,0,40,38,2,6
"2011","N00003689 (Bessbrook ward)","N00003689",138,47,26,21,0,29,29,0,54,48,6,8
"2011","N00003690 (Binnian ward)","N00003690",172,138,87,51,1,2,2,0,30,23,7,1
"2011","N00003691 (Binnian ward)","N00003691",141,127,77,50,0,0,0,0,10,10,0,4
"2011","N00003692 (Binnian ward)","N00003692",143,124,67,57,0,5,5,0,9,6,3,5
"2011","N00003693 (Binnian ward)","N00003693",149,99,44,55,0,16,16,0,31,30,1,3
"2011","N00003694 (Binnian ward)","N00003694",156,137,74,63,0,0,0,0,16,15,1,3
"2011","N00003695 (Binnian ward)","N00003695",147,110,63,47,0,2,2,0,29,26,3,6
"2011","N00003696 (Binnian ward)","N00003696",144,126,85,41,0,0,0,0,12,10,2,6
"2011","N00003697 (Burren and Kilbroney ward)","N00003697",135,108,55,53,0,1,1,0,24,21,3,2
"2011","N00003698 (Burren and Kilbroney ward)","N00003698",208,171,77,94,1,3,3,0,29,26,3,4
"2011","N00003699 (Burren and Kilbroney ward)","N00003699",134,112,67,45,0,1,1,0,18,16,2,3
"2011","N00003700 (Burren and Kilbroney ward)","N00003700",134,100,58,42,0,12,12,0,16,11,5,6
"2011","N00003701 (Burren and Kilbroney ward)","N00003701",177,153,62,91,0,4,4,0,18,15,3,2
"2011","N00003702 (Burren and Kilbroney ward)","N00003702",239,217,75,142,0,1,0,1,18,17,1,3
"2011","N00003703 (Burren and Kilbroney ward)","N00003703",185,147,50,97,1,0,0,0,36,35,1,1
"2011","N00003704 (Burren and Kilbroney ward)","N00003704",152,106,62,44,0,11,11,0,30,23,7,5
"2011","N00003705 (Camlough ward)","N00003705",170,123,64,59,0,13,13,0,30,25,5,4
"2011","N00003706 (Camlough ward)","N00003706",193,123,51,72,0,18,15,3,44,37,7,8
"2011","N00003707 (Camlough ward)","N00003707",157,142,69,73,0,3,3,0,6,4,2,6
"2011","N00003708 (Camlough ward)","N00003708",164,138,72,66,0,0,0,0,19,19,0,7
"2011","N00003709 (Camlough ward)","N00003709",143,99,45,54,0,13,13,0,29,27,2,2
"2011","N00003710 (Camlough ward)","N00003710",161,91,33,58,0,35,28,7,34,32,2,1
"2011","N00003711 (Camlough ward)","N00003711",165,140,74,66,0,0,0,0,16,11,5,9
"2011","N00003712 (Clonallan ward)","N00003712",147,102,64,38,0,13,1,12,31,28,3,1
"2011","N00003713 (Clonallan ward)","N00003713",157,90,18,72,1,22,22,0,40,38,2,4
"2011","N00003714 (Clonallan ward)","N00003714",157,60,22,38,1,81,50,31,9,8,1,6
"2011","N00003715 (Clonallan ward)","N00003715",122,77,45,32,0,19,19,0,21,19,2,5
"2011","N00003716 (Clonallan ward)","N00003716",150,81,45,36,1,19,19,0,41,37,4,8
"2011","N00003717 (Clonallan ward)","N00003717",144,59,39,20,0,3,2,1,80,71,9,2
"2011","N00003718 (Clonallan ward)","N00003718",487,382,167,215,3,30,6,24,68,59,9,4
"2011","N00003719 (Clonallan ward)","N00003719",150,115,28,87,2,1,1,0,30,30,0,2
"2011","N00003720 (Clonallan ward)","N00003720",143,114,45,69,1,5,4,1,22,17,5,1
"2011","N00003721 (Creggan ward)","N00003721",170,133,73,60,0,18,8,10,14,10,4,5
"2011","N00003722 (Creggan ward)","N00003722",152,130,71,59,0,0,0,0,17,10,7,5
"2011","N00003723 (Creggan ward)","N00003723",135,116,66,50,1,2,2,0,14,12,2,2
"2011","N00003724 (Creggan ward)","N00003724",136,127,77,50,0,2,1,1,6,5,1,1
"2011","N00003725 (Creggan ward)","N00003725",118,71,49,22,0,20,15,5,23,20,3,4
"2011","N00003726 (Creggan ward)","N00003726",148,125,73,52,0,6,6,0,13,12,1,4
"2011","N00003727 (Creggan ward)","N00003727",147,82,38,44,0,34,19,15,28,22,6,3
"2011","N00003728 (Crossmaglen ward)","N00003728",120,101,63,38,1,6,4,2,11,9,2,1
"2011","N00003729 (Crossmaglen ward)","N00003729",150,103,63,40,1,11,10,1,29,23,6,6
"2011","N00003730 (Crossmaglen ward)","N00003730",133,122,78,44,0,1,0,1,7,7,0,3
"2011","N00003731 (Crossmaglen ward)","N00003731",126,98,63,35,0,10,9,1,12,11,1,6
"2011","N00003732 (Crossmaglen ward)","N00003732",299,153,107,46,1,96,49,47,38,35,3,11
"2011","N00003733 (Crossmaglen ward)","N00003733",139,72,22,50,0,35,34,1,23,22,1,9
"2011","N00003734 (Daisy Hill ward)","N00003734",134,72,24,48,1,42,42,0,16,15,1,3
"2011","N00003735 (Daisy Hill ward)","N00003735",124,51,32,19,0,35,34,1,32,29,3,6
"2011","N00003736 (Daisy Hill ward)","N00003736",128,69,32,37,1,37,35,2,18,16,2,3
"2011","N00003737 (Daisy Hill ward)","N00003737",174,59,11,48,1,73,57,16,35,32,3,6
"2011","N00003738 (Daisy Hill ward)","N00003738",120,66,40,26,1,21,19,2,28,26,2,4
"2011","N00003739 (Daisy Hill ward)","N00003739",153,92,28,64,0,19,19,0,39,38,1,3
"2011","N00003740 (Daisy Hill ward)","N00003740",106,57,11,46,1,18,18,0,26,23,3,4
"2011","N00003741 (Daisy Hill ward)","N00003741",114,51,33,18,1,20,5,15,35,31,4,7
"2011","N00003742 (Daisy Hill ward)","N00003742",133,73,45,28,1,19,19,0,37,32,5,3
"2011","N00003743 (Derryleckagh ward)","N00003743",165,129,45,84,1,4,4,0,30,25,5,1
"2011","N00003744 (Derryleckagh ward)","N00003744",128,96,38,58,0,13,13,0,16,13,3,3
"2011","N00003745 (Derryleckagh ward)","N00003745",152,142,87,55,0,0,0,0,7,6,1,3
"2011","N00003746 (Derryleckagh ward)","N00003746",111,94,27,67,0,1,1,0,12,10,2,4
"2011","N00003747 (Derryleckagh ward)","N00003747",122,94,53,41,1,2,2,0,20,18,2,5
"2011","N00003748 (Derryleckagh ward)","N00003748",137,107,42,65,0,8,8,0,18,15,3,4
"2011","N00003749 (Derryleckagh ward)","N00003749",179,127,43,84,0,2,1,1,48,43,5,2
"2011","N00003750 (Derryleckagh ward)","N00003750",158,135,35,100,0,0,0,0,22,22,0,1
"2011","N00003751 (Derryleckagh ward)","N00003751",187,157,77,80,1,2,2,0,27,24,3,0
"2011","N00003752 (Derryleckagh ward)","N00003752",145,112,45,67,1,1,1,0,26,25,1,5
"2011","N00003753 (Derrymore ward)","N00003753",181,104,32,72,0,46,30,16,27,26,1,4
"2011","N00003754 (Derrymore ward)","N00003754",128,102,53,49,0,6,6,0,15,15,0,5
"2011","N00003755 (Derrymore ward)","N00003755",162,120,65,55,1,3,3,0,36,34,2,2
"2011","N00003756 (Derrymore ward)","N00003756",113,26,9,17,0,70,69,1,13,13,0,4
"2011","N00003757 (Derrymore ward)","N00003757",112,80,37,43,0,12,10,2,18,17,1,2
"2011","N00003758 (Derrymore ward)","N00003758",207,149,39,110,2,24,21,3,32,31,1,0
"2011","N00003759 (Derrymore ward)","N00003759",140,73,40,33,0,38,21,17,22,19,3,7
"2011","N00003760 (Derrymore ward)","N00003760",121,54,24,30,0,45,42,3,21,20,1,1
"2011","N00003761 (Donaghmore ward)","N00003761",136,102,43,59,0,9,8,1,21,21,0,4
"2011","N00003762 (Donaghmore ward)","N00003762",160,143,75,68,0,1,1,0,9,7,2,7
"2011","N00003763 (Donaghmore ward)","N00003763",156,136,63,73,0,5,5,0,12,10,2,3
"2011","N00003764 (Donaghmore ward)","N00003764",178,156,78,78,0,0,0,0,18,14,4,4
"2011","N00003765 (Donaghmore ward)","N00003765",134,123,73,50,0,1,1,0,7,7,0,3
"2011","N00003766 (Donaghmore ward)","N00003766",145,124,61,63,0,5,5,0,15,14,1,1
"2011","N00003767 (Donaghmore ward)","N00003767",145,130,63,67,1,1,0,1,10,4,6,3
"2011","N00003768 (Drumalane ward)","N00003768",216,133,49,84,0,8,6,2,72,67,5,3
"2011","N00003769 (Drumalane ward)","N00003769",132,92,57,35,2,9,8,1,26,26,0,3
"2011","N00003770 (Drumalane ward)","N00003770",182,92,32,60,0,26,26,0,59,56,3,5
"2011","N00003771 (Drumalane ward)","N00003771",188,85,36,49,0,21,21,0,81,76,5,1
"2011","N00003772 (Drumalane ward)","N00003772",113,39,25,14,1,43,43,0,22,21,1,8
"2011","N00003773 (Drumalane ward)","N00003773",142,84,54,30,2,14,14,0,36,33,3,6
"2011","N00003774 (Drumalane ward)","N00003774",122,96,54,42,2,0,0,0,22,20,2,2
"2011","N00003775 (Drumalane ward)","N00003775",192,162,78,84,2,2,2,0,22,20,2,4
"2011","N00003776 (Drumgullion ward)","N00003776",140,116,71,45,0,11,9,2,11,10,1,2
"2011","N00003777 (Drumgullion ward)","N00003777",111,65,32,33,1,24,19,5,18,16,2,3
"2011","N00003778 (Drumgullion ward)","N00003778",167,44,23,21,1,69,24,45,44,39,5,9
"2011","N00003779 (Drumgullion ward)","N00003779",137,32,19,13,0,73,61,12,20,20,0,12
"2011","N00003780 (Drumgullion ward)","N00003780",117,80,18,62,3,2,2,0,31,30,1,1
"2011","N00003781 (Drumgullion ward)","N00003781",135,105,38,67,0,9,9,0,20,18,2,1
"2011","N00003782 (Drumgullion ward)","N00003782",193,146,56,90,0,5,5,0,40,40,0,2
"2011","N00003783 (Drumgullion ward)","N00003783",140,65,25,40,0,38,38,0,30,28,2,7
"2011","N00003784 (Fathom ward)","N00003784",152,123,57,66,1,12,10,2,14,13,1,2
"2011","N00003785 (Fathom ward)","N00003785",163,150,79,71,0,2,1,1,5,4,1,6
"2011","N00003786 (Fathom ward)","N00003786",159,129,38,91,4,2,1,1,22,22,0,2
"2011","N00003787 (Fathom ward)","N00003787",135,120,62,58,1,2,1,1,10,7,3,2
"2011","N00003788 (Fathom ward)","N00003788",155,81,48,33,0,14,11,3,54,50,4,6
"2011","N00003789 (Fathom ward)","N00003789",140,128,74,54,0,0,0,0,9,8,1,3
"2011","N00003790 (Fathom ward)","N00003790",139,89,56,33,0,19,8,11,28,25,3,3
"2011","N00003791 (Forkhill ward)","N00003791",251,186,87,99,4,18,8,10,40,39,1,3
"2011","N00003792 (Forkhill ward)","N00003792",122,79,41,38,1,21,21,0,18,18,0,3
"2011","N00003793 (Forkhill ward)","N00003793",202,176,83,93,2,0,0,0,20,15,5,4
"2011","N00003794 (Forkhill ward)","N00003794",144,93,36,57,1,11,11,0,35,29,6,4
"2011","N00003795 (Forkhill ward)","N00003795",146,130,62,68,0,1,1,0,12,11,1,3
"2011","N00003796 (Forkhill ward)","N00003796",199,187,95,92,0,0,0,0,9,7,2,3
"2011","N00003797 (Forkhill ward)","N00003797",177,123,58,65,0,14,13,1,33,32,1,7
"2011","N00003798 (Forkhill ward)","N00003798",169,94,36,58,2,37,21,16,30,28,2,6
"2011","N00003799 (Kilkeel Central ward)","N00003799",126,86,36,50,2,1,1,0,33,29,4,4
"2011","N00003800 (Kilkeel Central ward)","N00003800",153,125,65,60,1,0,0,0,26,24,2,1
"2011","N00003801 (Kilkeel Central ward)","N00003801",174,102,78,24,2,7,7,0,61,61,0,2
"2011","N00003802 (Kilkeel Central ward)","N00003802",107,86,40,46,2,0,0,0,15,13,2,4
"2011","N00003803 (Kilkeel Central ward)","N00003803",145,104,68,36,0,3,2,1,37,31,6,1
"2011","N00003804 (Kilkeel Central ward)","N00003804",140,117,65,52,1,3,1,2,17,16,1,2
"2011","N00003805 (Kilkeel Central ward)","N00003805",117,66,26,40,1,19,19,0,29,26,3,2
"2011","N00003806 (Kilkeel Central ward)","N00003806",169,68,31,37,2,65,41,24,26,25,1,8
"2011","N00003807 (Kilkeel Central ward)","N00003807",128,39,17,22,1,56,54,2,29,25,4,3
"2011","N00003808 (Kilkeel Central ward)","N00003808",143,69,33,36,0,14,14,0,50,45,5,10
"2011","N00003809 (Kilkeel South ward)","N00003809",147,121,77,44,0,2,2,0,22,20,2,2
"2011","N00003810 (Kilkeel South ward)","N00003810",109,53,37,16,1,28,28,0,22,20,2,5
"2011","N00003811 (Kilkeel South ward)","N00003811",141,109,72,37,1,4,3,1,25,22,3,2
"2011","N00003812 (Kilkeel South ward)","N00003812",127,86,50,36,1,14,14,0,19,14,5,7
"2011","N00003813 (Kilkeel South ward)","N00003813",127,86,54,32,2,1,1,0,35,31,4,3
"2011","N00003814 (Kilkeel South ward)","N00003814",151,106,53,53,1,7,7,0,35,30,5,2
"2011","N00003815 (Kilkeel South ward)","N00003815",227,104,14,90,0,43,35,8,80,78,2,0
"2011","N00003816 (Kilkeel South ward)","N00003816",143,68,32,36,0,41,41,0,30,29,1,4
"2011","N00003817 (Lisnacree ward)","N00003817",149,126,64,62,0,3,3,0,15,13,2,5
"2011","N00003818 (Lisnacree ward)","N00003818",156,117,65,52,1,14,5,9,16,14,2,8
"2011","N00003819 (Lisnacree ward)","N00003819",135,112,77,35,0,1,0,1,19,15,4,3
"2011","N00003820 (Lisnacree ward)","N00003820",179,161,87,74,0,2,1,1,13,10,3,3
"2011","N00003821 (Lisnacree ward)","N00003821",139,113,68,45,0,9,9,0,10,8,2,7
"2011","N00003822 (Lisnacree ward)","N00003822",167,142,89,53,0,0,0,0,23,21,2,2
"2011","N00003823 (Mayobridge ward)","N00003823",190,171,75,96,0,2,2,0,12,12,0,5
"2011","N00003824 (Mayobridge ward)","N00003824",226,194,86,108,0,3,2,1,23,17,6,6
"2011","N00003825 (Mayobridge ward)","N00003825",325,248,86,162,0,26,20,6,48,39,9,3
"2011","N00003826 (Mayobridge ward)","N00003826",201,179,93,86,0,1,1,0,17,14,3,4
"2011","N00003827 (Mayobridge ward)","N00003827",311,283,141,142,0,0,0,0,17,15,2,11
"2011","N00003828 (Newtownhamilton ward)","N00003828",139,118,76,42,0,2,2,0,9,8,1,10
"2011","N00003829 (Newtownhamilton ward)","N00003829",150,135,74,61,0,3,2,1,7,7,0,5
"2011","N00003830 (Newtownhamilton ward)","N00003830",166,129,67,62,1,2,0,2,30,22,8,4
"2011","N00003831 (Newtownhamilton ward)","N00003831",125,79,49,30,0,10,10,0,28,26,2,8
"2011","N00003832 (Newtownhamilton ward)","N00003832",183,146,83,63,0,4,3,1,27,26,1,6
"2011","N00003833 (Newtownhamilton ward)","N00003833",193,66,22,44,0,85,78,7,34,30,4,8
"2011","N00003834 (Rostrevor ward)","N00003834",157,68,36,32,1,52,28,24,33,30,3,3
"2011","N00003835 (Rostrevor ward)","N00003835",243,143,91,52,1,43,7,36,47,44,3,9
"2011","N00003836 (Rostrevor ward)","N00003836",147,94,67,27,0,12,12,0,39,35,4,2
"2011","N00003837 (Rostrevor ward)","N00003837",113,93,45,48,2,2,2,0,15,14,1,1
"2011","N00003838 (Rostrevor ward)","N00003838",179,121,72,49,0,4,2,2,50,46,4,4
"2011","N00003839 (Rostrevor ward)","N00003839",132,100,67,33,0,1,1,0,24,19,5,7
"2011","N00003840 (Rostrevor ward)","N00003840",152,125,84,41,1,3,3,0,19,18,1,4
"2011","N00003841 (Seaview ward)","N00003841",114,89,52,37,0,4,4,0,19,15,4,2
"2011","N00003842 (Seaview ward)","N00003842",165,118,55,63,3,1,1,0,39,36,3,4
"2011","N00003843 (Seaview ward)","N00003843",130,73,46,27,0,2,1,1,53,49,4,2
"2011","N00003844 (Seaview ward)","N00003844",182,156,82,74,0,4,3,1,20,14,6,2
"2011","N00003845 (Seaview ward)","N00003845",121,95,45,50,1,8,8,0,11,11,0,6
"2011","N00003846 (Seaview ward)","N00003846",294,103,41,62,3,99,57,42,77,71,6,12
"2011","N00003847 (Seaview ward)","N00003847",114,61,36,25,1,29,28,1,18,13,5,5
"2011","N00003848 (Seaview ward)","N00003848",138,85,48,37,1,23,23,0,29,28,1,0
"2011","N00003849 (Silver Bridge ward)","N00003849",181,154,84,70,1,3,1,2,20,19,1,3
"2011","N00003850 (Silver Bridge ward)","N00003850",143,111,59,52,0,13,13,0,12,9,3,7
"2011","N00003851 (Silver Bridge ward)","N00003851",149,136,72,64,0,2,2,0,9,8,1,2
"2011","N00003852 (Silver Bridge ward)","N00003852",141,64,27,37,0,47,34,13,23,17,6,7
"2011","N00003853 (Silver Bridge ward)","N00003853",167,141,77,64,0,4,4,0,17,15,2,5
"2011","N00003854 (Silver Bridge ward)","N00003854",137,125,60,65,0,0,0,0,11,8,3,1
"2011","N00003855 (Silver Bridge ward)","N00003855",150,131,75,56,0,4,4,0,14,10,4,1
"2011","N00003856 (Silver Bridge ward)","N00003856",159,135,61,74,1,2,2,0,19,19,0,2
"2011","N00003857 (Spelga ward)","N00003857",169,127,57,70,0,2,1,1,38,30,8,2
"2011","N00003858 (Spelga ward)","N00003858",159,138,88,50,0,3,3,0,15,13,2,3
"2011","N00003859 (Spelga ward)","N00003859",179,98,53,45,1,27,23,4,49,48,1,4
"2011","N00003860 (Spelga ward)","N00003860",360,262,100,162,2,21,12,9,68,58,10,7
"2011","N00003861 (Spelga ward)","N00003861",169,142,80,62,0,2,1,1,17,12,5,8
"2011","N00003862 (Spelga ward)","N00003862",136,118,73,45,0,3,3,0,12,10,2,3
"2011","N00003863 (St Marys ward)","N00003863",117,45,31,14,1,23,23,0,39,36,3,9
"2011","N00003864 (St Marys ward)","N00003864",130,90,45,45,0,12,12,0,24,19,5,4
"2011","N00003865 (St Marys ward)","N00003865",100,47,28,19,2,12,11,1,36,34,2,3
"2011","N00003866 (St Marys ward)","N00003866",147,92,47,45,0,21,21,0,32,30,2,2
"2011","N00003867 (St Marys ward)","N00003867",276,142,78,64,0,62,24,38,65,61,4,7
"2011","N00003868 (St Marys ward)","N00003868",142,80,44,36,0,26,26,0,31,28,3,5
"2011","N00003869 (St Patricks ward)","N00003869",445,222,90,132,2,69,38,31,140,126,14,12
"2011","N00003870 (St Patricks ward)","N00003870",117,52,29,23,1,20,20,0,43,38,5,1
"2011","N00003871 (St Patricks ward)","N00003871",239,212,71,141,0,1,1,0,26,21,5,0
"2011","N00003872 (St Patricks ward)","N00003872",129,50,29,21,1,27,27,0,47,45,2,4
"2011","N00003873 (St Patricks ward)","N00003873",413,251,111,140,1,74,73,1,77,66,11,10
"2011","N00003874 (Tullyhappy ward)","N00003874",173,151,80,71,1,10,10,0,7,5,2,4
"2011","N00003875 (Tullyhappy ward)","N00003875",140,92,28,64,1,11,10,1,32,30,2,4
"2011","N00003876 (Tullyhappy ward)","N00003876",167,157,71,86,0,1,1,0,7,6,1,2
"2011","N00003877 (Tullyhappy ward)","N00003877",129,106,59,47,0,11,11,0,9,8,1,3
"2011","N00003878 (Tullyhappy ward)","N00003878",142,131,70,61,0,0,0,0,8,8,0,3
"2011","N00003879 (Tullyhappy ward)","N00003879",147,131,72,59,0,0,0,0,10,7,3,6
"2011","N00003880 (Tullyhappy ward)","N00003880",173,137,49,88,1,14,14,0,17,15,2,4
"2011","N00003881 (Windsor Hill ward)","N00003881",149,128,60,68,0,2,2,0,18,16,2,1
"2011","N00003882 (Windsor Hill ward)","N00003882",125,95,56,39,4,1,1,0,25,25,0,0
"2011","N00003883 (Windsor Hill ward)","N00003883",299,232,144,88,0,4,3,1,61,56,5,2
"2011","N00003884 (Windsor Hill ward)","N00003884",289,166,85,81,1,35,9,26,77,70,7,10
"2011","N00003885 (Windsor Hill ward)","N00003885",119,79,29,50,1,22,21,1,14,14,0,3
"2011","N00003886 (Windsor Hill ward)","N00003886",117,61,20,41,0,30,17,13,24,19,5,2
